>T0387 PDZK1A, Homo sapiens, 91 residues	SMKPKLCRLAKGENGYGFHLNAIRGLPGSFIKEVQKGGPADLAGLEDEDVIIEVNGVNVLDEPYEKVVDRIQSSGKNVTLLVCGKKAQDTV
>T0388 LOC493869A, Homo sapiens, 174 residues	ENLYFQSMINSFYAFEVKDAKGRTVSLEKYKGKVSLVVNVASDCQLTDRNYLGLKELHKEFGPSHFSVLAFPCNQFGESEPRPSKEVESFARKNYGVTFPIFHKIKILGSEGEPAFRFLVDSSKKEPRWNFWKYLVNPEGQVVKFWRPEEPIEVIRPDIAALVRQVIIKKKEDL
>T0389 DUSP16A, Homo sapiens, 153 residues	MIGTQIVTERLVALLESGTEKVLLIDSRPFVEYNTSHILEAININCSKLMKRRLQQDKVLITELIQHSAKHKVDIDCSQKVVVYDQSSQDVASLSSDCFLTVLLGKLEKSFNSVHLLAGGFAEFSRCFPGLCEGKSTLVPTCISQPAHHHHHH
>T0390 EFNA1A, Homo sapiens, 182 residues	AAPEHHHHHHDYDIPTTENLYFQGAMDAADRHTVFWNSSNPKFRNEDYTIHVQLNDYVDIICPHYEDHSVADAAMEQYILYLVEHEEYQLCQPQSKDQVRWQCNRPSAKHGPEKLSEKFQRFTPFTLGKEFKEGHSYYYISKPIHQHEDRCLRLKVTVSGKITHSPQAHVNPQEKRLAADDP
>T0391 rieske ferredoxin, mouse, 157 residues	SDPEISEQDEEKKKYTSVCVGREEDIRKSERMTAVVHDREVVIFYHKGEYHAMDIRCYHSGGPLHLGEIEDFNGQSCIVCPWHKYKITLATGEGLYQSINPKDPSAKPKWCSKGVKQRIHTVKVDNGNIYVTLSKEPFKCDSDYYATGEFKVIQSSS
>T0392 RHPN2A, Homo sapiens, 109 residues	MHHHHHHSSGVDLGTENLYFQSMPRSIRFTAEEGDLGFTLRGNAPVQVHFLDPYCSASVAGAREGDYIVSIQLVDCKWLTLSEVMKLLKSFGEDEIEMKVVSLLDEVTF
>T0393 BF3122, Bacteroides fragilis, 263 residues	MKRSIEDTPIVLIGAGNLATNLAKALYRKGFRIVQVYSRTEESARELAQKVEAEYTTDLAEVNPYAKLYIVSLKDSAFAELLQGIVEGKREEALMVHTAGSIPMNVWEGHVPHYGVFYPMQTFSKQREVDFKEIPFFIEASSTEDAAFLKAIASTLSNRVYDADSEQRKSLHLAAVFTCNFTNHMYALAAELLKKYNLPFDVMLPLIDETARKVHELEPKTAQTGPAIRYDENVIGNHLRMLADDPAMQRLYELLSRSIHERQ
>T0394 chr_12_orf_5 , homo sapiens, 275 residues	NLYFQSARFALTVVRHGETRFNKEKIIQGQGVDEPLSETGFKQAAAAGIFLNNVKFTHAFSSDLMRTKQTMHGILERSKFCKDMTVKYDSRLRERKYGVVEGKALSELRAMAKAAREECPVFTPPGGETLDQVKMRGIDFFEFLCQLILKEADQKEQFSQGSPSNCLETSLAEIFPLGKNHSSKVNSDSGIPGLAASVLVVSHGAYMRSLFDYFLTDLKCSLPATLSRSELMSVTPNTGMSLFIINFEEGREVKPTVQCICMNLQDHLNGLTETR
>T0395 Flavin_MAT, Candida glabrata, 304 residues	MRLGDAAELCYNLTSSYLQIAAESDSIIAQTQRAINTTKSILINETFPKWSPLNGEISFSYNGGKDCQVLLLLYLSCLWEYYIVKLSQSQFDGKFHRFPLTKLPTVFIDHDDTFKTLENFIEETSLRYSLSLYESDRDKCETMAEAFETFLQVFPETKAIVIGIRHTDPFGEHLKPIQKTDANWPDFYRLQPLLHWNLANIWSFLLYSNEPICELYRYGFTSLGNVEETLPNPHLRKDKNSTPLKLNFEWEIENRYKHNEVTKAEPIPIADEDLVKIENLHEDYYPGWYLVDDKLERAGRIKKK
>T0396 pB119L, African Swine Fever Virus, 105 residues	GSMLHWGPKYWRSLHLYAIFFSDAPSWKEKYEAIQWILNFIESLPCTRCQHHAFSYLTKNPLTLNNSEDFQYWTFAFHNNVNNRLNKKIISWSEYKNIYEQSILK
>T0397 hypothetical protein MMP0046, Methanococcus maripaludis s2, 150 residues	MKIPKIYVEGELNDGDRVAIEKDGNAIIFLEKDEEYSGNGKLLYQVIYDDLAKYMSLDTLKKDVLIQYPDKHTLTYLKAGTKLISVPAEGYKVYPIMDFGFRVLKGYRLATLESKKGDLRYVNSPVSGTVIFMNEIPSERANYVFYMLEE
>T0398 NP_243269.1, BACILLUS HALODURANS, 292 residues	MLTGKHVVIIGGDARQLEIIRKLSTFDAKISLVGFDQLDDGFIGVTKMRIDEVDWNTVDAILLPISGTNEAGKVDTIFSNESIVLTEEMIEKTPNHCVVYSGISNTYLNQCMKKTNRTLVKLMERDDIAIYNSIPTAEGTIMMAIQHTDFTIHGANVAVLGLGRVGMSVARKFAALGAKVKVGARESDLLARIAEMGMEPFHISKAAQELRDVDVCINTIPALVVTANVLAEMPSHTFVIDLASKPGGTDFRYAEKRGIKALLVPGLPGIVAPKTAGRILADVLVKLLAEPS
>T0399 Putative beta-lactamase inhibitor protein, Streptococcus mutans, 206 residues	MSMKKTKNWLLVFLTVTFCFLMLGCQSKEDKKGGTKPSNEAALTKTENLDFRLSFNKIKVTTDQNHFSGGTSIEQLKQWFGDPNKSEQRNAGNITLDSYTWVKDGAVINAQLYKNSTVARSISNFSFSREAKIGKEDYDELKIGESYKKVVEKLGEPDVLSQSMSSDKEEMQTVWSSGIKTKSSSATIELYFENGLLKNKTQKDLE
>T0400 NP_373092.1, Staphylococcus aureus, 162 residues	MAINIIEYNRSYKEELIEFILSIQKNEFNIKIDRDDQPDLENIEHNYLNSGGQFWLAINNHQNIVGTIGLIRLDNNMSALKKMFVDKGYRNLKIGKKLLDKVIMTCKEQNIDGIYLGTIDKFISAQYFYSNNGFREIKRGDLPSSFPKLDVDNRFYYRNLKD
>T0401 YP_211376.1, Bacteroides fragilis, 143 residues	MEVIESKWYKKDGASSASIDDVEKLLNTTLPKQYKSFLLWSNGGEGKLGDNYIYIWAIEDVIAYNHDYGIQKYLQKEYWAFGMDGDIGYILHLSDNSIYRVDLGDLDITSIKYIAPSFDDFLGKAIYLNFNKLQNVANNNLTT
>T0402 NP_472219.1, LISTERIA INNOCUA, 139 residues	MENELEDKILAILEQHQVGVLTSVQGDFPHARYMTFLHDGLTLYTPSGKELPKTEEVRRNPHVCVLIGYDSPGSAFLEINGLASLEEDESIKERIWENISKDWFQGEDSPSFVVIKIVPEQIRILNSDDDGPDTLDLIG
>T0403 PorB, Neisseria Menigitidis, 339 residues	MGRDLQVTLYGTIKAGVEVSRVKDAGTYKAQGGKSKTATQIADFGSKIGFKGQEDLGNGMKAIWQLEQKASIAGTNSGWGNRQSFIGLKGGFGTVRAGNLNTVLKDSGDNVNAWESGSNTEDVLGLGTIGRVESREISVRYDSPVFAGFSGSVQYVPRDNANDVDKYKHTKSSRESYHAGLKYENAGFFGQYAGSFAKYADLNTDAERVAVNTANAHPVKDYQVHRVVAGYDANDLYVSVAGQYEAAKNNEVGSIKGKKHEQTQVAATAAYRFGNVTPRVSYAHGFKAKVNGVKDANYQYDQVIVGADYDFSKRTSALVSAGWLKQGKGAGKVEQTASM
>T0404 YP_323533.1, Anabaena variabilis, 110 residues	MSKRANKLVIVTEKVLLKKVAKIIEEAGATGYTVVDTGGKGSRNVRSTGKPNTSDTDSNVKFEVLTENREMAEKIADQVAIKFFTDYAGIIYICEAEVLYGRTFCGPDGC
>T0405 lmo0819, listeria  monocytogenes, 282 residues	MNETEKLVAALLERNFGKNIGTRYPGNEAAQMRAEEVIGEIAIVIAPLVEKLGIENKTVKKTIPFLYELQKNQFCDMSAYPYPLLLVNGTSTDTEKYWRDLPTYWTDDANKIVLPYVLEHIKNNKVRQKLLAFHAWLLGEVVEMNEALGADFRVKLVFESDMRIRLRVYEVEQIAIEVHFLDNHDTEQQHLGYDVSLDADFTEKARLLLRQGILTENLGLEALKAYMKSVLPIAHSLKNLEHLTFEETKKLTKLLTQEEPKIMEDTDLTSKALDFLQKAAQQ
>T0406 NP_980948.1, BACILLUS CEREUS, 167 residues	MYQTIEGFLQSWTYETESTQKMLDVLTDESLSQEIAPGHWTLGRVAWHIVTAIPVILSGTGLKFEGETKDYPVPTSAKTIADGYRKVNTAFVEALQSEWTDKDLTTINDFFGRPMPNSIFLMTLINHQNHHRGQMTVLMRQAGLTVPGVYGPAKEEWATAGMEAPKM
>T0407 YP_001300751.1, Bacteroides vulgatus, 363 residues	MEVKKVLVSAFLLTTCLMSGQAQRRNEIQVPDLDGYTTLKCDFHMHSVFSDGLVWPTVRVDEAYRDGLDAISLTEHIEYRPHKQDVVSDHNRSFDLCREQAEKLGILLIKGSEITRAMAPGHFNAIFLSDSNPLEQKDYKDAFREAKKQGAFMFWNHPGWDSQQPDTTKWWPEHTALYQEGCMHGIEVANGHLYMPEAIQWCLDKNLTMIGTSDIHQPIQTDYDFEKGEHRTMTFVFAKERSLQGIREALDNRRTAAYFHELLIGREDLLRPFFEKCVKIEEVSRNEQGVTLSITNVTDLVLKLKKTAHDTLLVYFRDMTLKPHTRYTVRIGFKQGIKGGDVNFEVTNFIVAPDKGLKYTISL
>T0408 Hypothetical protein MJ0742, Methanococcus jannaschii, 104 residues	MKNEVFFGEGMKVVKEKYPDLYDIIVKLNDTVFTGKTLDYKTQKLIAIGIVASRCDEVAIEKQMKSAMKELGITKEEIADVLRVVLLTSGMPAFTKAMKILEKL
>T0409 residues 318...420 mrcA, Nitrosomonas europaea ATCC 19718, 103 residues	YRGPEAFLKLPKDLKDREALQDIMQDIGNSDDILAAVVLSATPGAVEAFRKNGETIRITGDGLKAAHRFLSNDPKIGEKRIRPGALIRVKKTEKGSWQIVQLP
>T0410 ALOX12A, Homo sapiens, 541 residues	MHHHHHHSSGVDLGTENLDFEWTLKAGALEMALKRVYTLLSSWNCLEDFDQIFWGQKSALAEKVRQCWQDDELFSYQFLNGANPMLLRRSTSLPSRLVLPSGMEELRAQLEKELQNGSLFEADFILLDGIPANVIRGEKQYLAAPLVMLKMEPNGKLQPMVIQIQPPNPSSPTPTLFLPSDPPLAWLLAKSWVRNSDFQLHEIQYHLLNTHLVAEVIAVATMRCLPGLHPIFKFLIPHIRYTMEINTRARTQLISDGGIFDKAVSTGGGGHVQLLRRAAAQLTYCSLCPPDDLADRGLLGLPGALYAHDALRLWEIIARYVEGIVHLFYQRDDIVKGDPELQAWCREITEVGLCQAQDRGFPVSFQSQSQLCHFLTMCVFTCTAQHAAINQGQLDWYAWVPNAPCTMRMPPPTTKEDVTMATVMGSLPDVRQACLQMAISWHLSRRQPDMVPLGHHKEKYFSGPKPKAVLNQFRTDLEKLEKEITARNEQLDWPYEYLKPSCIENSVTSDSKGGYGSEFELRRQACGRTRAPPPPPLRSGC
>T0411 Protein of unknown function, localized to the mitochondrial outer, Saccharomyces cerevisiae, 139 residues	MWKAVMNAWNGTESQSKNVSNIQSYSFEDMKRIVGKHDPNVVLVDVREPSEYSIVHIPASINVPYRSHPDAFALDPLEFEKQIGIPKPDSAKELIFYCASGKRGGEAQKVASSHGYSNTSLYPGSMNDWVSHGGDKLDL
>T0412 ACIAD1822 effector domain, Putative IclR, Acinetobacter sp. ADP1, 178 residues	SNALFSSRDILEVLQDIHMETGETVAIATKNDIYLQYIQIIESVHALRFHVDENAIRPLTMSSNGWMLMSTMNDKAIDNTVRRANTITQKDGIRFEVDDMMARIRQVREQGYASAEHIPFVGGGTICVLLPMTIQGQPVTMGLGGALDRIKQNYDRYLELLLNGVQQLKKSDSFHQPI
>T0413 BPP4128, LpqC, Bordetella parapertussis, 304 residues	SNAMKPADLTNADRIALELGHAGRNAIPYLDDDRNADRPFTLNTYRPYGYTPDRPVVVVQHGVLRNGADYRDFWIPAADRHKLLIVAPTFSDEIWPGVESYNNGRAFTAAGNPRHVDGWTYALVARVLANIRAAEIADCEQVYLFGHSAGGQFVHRLMSSQPHAPFHAVTAANPGWYTLPTFEHRFPEGLDGVGLTEDHLARLLAYPMTILAGDQDIATDDPNLPSEPAALRQGPHRYARARHYYEAGQRAAAQRGLPFGWQLQVVPGIGHDGQAMSQVCASLWFDGRMPDAAELARLAGSQSA
>T0414 CA_C3497, conserved protein of unknown function, Clostridium acetobutylicum ATCC 824, 140 residues	SNAMKPDIYENNREGILCVYKNEKWLVCIKNWKPDNDIEGIAHLEIHHSTDEQFILSAGKAILITAEKENDKFNIELTLMEKGKVYNVPAECWFYSITQKDTKMMYVQDSNCSMDNSDFCDLSKEEIEYIQTNARKLFEK
>T0415 LytTr DNA-binding domain of putative methyl-accepting/DNA response regulator, Bacillus cereus, 109 residues	GKSVVTLKTTDGWIPVPFSKVMYLEAKDKKTYVNAEELTGTHKYSLQEFEYLLPKDSFIRCHRSFIVNVNHIKAIYPDTHSTFLLSMDNGERVPVSQSYASYFRKLLGF
>T0416 tRNA delta(2)-isopentenylpyrophosphate transferase, Staphylococcus epidermidis, 332 residues	MTEMTKPFLIVIVGPTASGKTELSIEVAKKFNGEIISGDSMQVYQGMDIGTAKVTTEEMEGIPHYMIDILPPDASFSAYEFKKRAEKYIKDITRRGKVPIIAGGTGLYIQSLLYNYAFEDESISEDKMKQVKLKLKELEHLNNNKLHEYLASFDKESAKDIHPNNRKRVLRAIEYYLKTKKLLSSRKKVQQFTENYDTLLIGIEMSRETLYLRINKRVDIMLGHGLFNEVQHLVEQGFEASQSMQAIGYKELVPVIKGNISMENAVEKLKQHSRQYAKRQLTWFKNKMNVHWLNKERMSLQMMLDEITTQINKRSSNHDCKRKHPRPSTREL
>T0417 BPP1888, L-2,4-diaminobutyric acid acetyltransferase, Bordetella parapertussis, 189 residues	SNAMRKDETSNTSPDISVAQPASALRYHLRPPRRNDGAAIHQLVSECPPLDLNSLYAYLLLCEHHAHTCVVAESPGGRIDGFVSAYLLPTRPDVLFVWQVAVHSRARGHRLGRAMLGHILERQECRHVRHLETTVGPDNQASRRTFAGLAGERGAHVSEQPFFDRQAFGGADHDDEMLLRIGPFTHPPH
>T0418 putative haloacid dehalogenase-like hydrolase, Bacteroides fragilis , 222 residues	MKYTVYLFDFDYTLADSSRGIVTCFRSVLERHGYTGITDDMIKRTIGKTLEESFSILTGITDADQLESFRQEYSKEADIYMNANTILFPDTLPTLTHLKKQGIRIGIISTKYRFRILSFLRNHMPDDWFDIIIGGEDVTHHKPDPEGLLLAIDRLKACPEEVLYIGDSTVDAGTAAAAGVSFTGVTSGMTTAQEFQAYPYDRIISTLGQLISVPEDKSGCPL
>T0419 PPk2, Pseudomonas aeruginosa PA01, 496 residues	MFESAEVGHSIDKDTYEKAVIELREALLEAQFELKQQARFPVIILINGIEGAGKGETVKLLNEWMDPRLIEVQSFLRPSDEELERPPQWRFWRRLPPKGRTGIFFGNWYSQMLYARVEGHIKEAKLDQAIDAAERFERMLCDEGALLFKFWFHLSKKQLKERLKALEKDPQHSWKLSPLDWKQSEVYDRFVHYGERVLRRTSRDYAPWYVVEGADERYRALTVGRILLEGLQAALATKERAKRQPHAAPLVSSLDNRGLLDSLDLGQYLDKDAYKEQLAAEQARLAGLIRDKRFRQHSLVAVFEGNDAAGKGGAIRRVTDALDPRQYHIVPIAAPTEEERAQPYLWRFWRHIPARRQFTIFDRSWYGRVLVERIEGFCAPADWLRAYGEINDFEEQLSEYGIIVVKFWLAIDKQTQMERFKEREKTPYKRYKITEEDWRNRDKWDQYVDAVGDMVDRTSTEIAPWTLVEANDKRFARVKVLRTINDAIEAAYKKDK
>T0420 Q97W15_SULSO, Sulfolobus solfataricus, 189 residues	MNIGVIILAAGEGKRFGGDKLLAKIDNTPIIMRTIRIYGDLEKIIIVGKYVNEMLPLLMDQIVIYNPFWNEGISTSLKLGLRFFKDYDAVLVALGDMPFVTKEDVNKIINTFKPNCKAVIPTHKGERGNPVLISKSLFNEIEKLRGDVGARVILNKIKIEELCFIECSEGVLIDIDKKEDLMRLRDFHP
>T0421  Putative polyphosphate kinase 2 , Sinorhizobium meliloti, 300 residues	MALDEAPAEARPGSRAVELEIDGRSRIFDIDDPDLPKWIDEEAFRSDDYPYKKKLDREEYEETLTKLQIELVKVQFWMQATGKRVMAVFEGRDAAGKGGAIHATTANMNPRSARVVALTKPTETERGQWYFQRYVATFPTAGEFVLFDRSWYNRAGVEPVMGFCTPDQYEQFLKEAPRFEEMIANEGIHLFKFWINIGREMQLKRFHDRRHDPLKIWKLSPMDIAALSKWDDYTGKRDRMLKETHTEHGPWAVIRGNDKRRSRINVIRHMLTKLDYDGKDEAAIGEVDEKILGSGPGFLR
>T0422 FIGNL1A, Homo sapiens, 357 residues	MHHHHHHSSGVDLGTENLYFQSMVPPIPKQDGGEQNGGMQCKPYGAGPTEPAHPVDERLKNLEPKMIELIMNEIMDHGPPVNWEDIAGVEFAKATIKEIVVWPMLRPDIFTGLRGPPKGILLFGPPGTGKTLIGKCIASQSGATFFSISASSLTSKWVGEGEKMVRALFAVARCQQPAVIFIDEIDSLLSQRGDGEHESSRRIKTEFLVQLDGATTSSEDRILVVGATNRPQEIDEAARRRLVKRLYIPLPEASARKQIVINLMSKEQCCLSEEEIEQIVQQSDAFSGADMTQLCREASLGPIRSLQTADIATITPDQVRPIAYIDFENAFRTVRPSVSPKDLELYENWNKTFGCGK
>T0423 Atu1372 , Agrobacterium tumefaciens str. C58, 156 residues	MSDVIEGRLKELGFTLPVAAAPAANYVPFTISGNLLYVSGQLPMESGKIAVTGLVGRDVDVASAQRAAELCAVNILAQVKAALNGDLSKIRRVIKLNGFVASVPEFVEQHLVINGASNLIATVLGEPGRHARAAVGMASLPFNASVEIDAIVEIDV
>T0424 AAF41501, Neisseria meningitidis MC58, 381 residues	MQNNSYGYAVSVRVGGKEHRHWERYDIDSDFLIPADSFDFVIGRLGPEAAIPDLSGESCEVVIDGQIVMTGIIGSQRHGKSKGSRELSLSGRDLAGFLVDCSAPQLNVKGMTVLDAAKKLAAPWPQIKAVVLKAENNPALGKIDIEPGETVWQALTHIANSVGLHPWLEPDGTLVVGGADYSSPPVATLCWSRTDSRCNIERMDIEWDTDNRFSEVTFLAQSHGRSGDSAKHDLKWVYKDPTMTLHRPKTVVVSDADNLAALQKQAKKQLADWRLEGFTLTITVGGHKTRDGVLWQPGLRVHVIDDEHGIDAVFFLMGRRFMLSRMDGTQTELRLKEDGIWTPDAYPKKAEAARKRKGKRKGVSHKGKKGGKKQAETAVFE
>T0425 putative N-acetylmuramoyl-L-alanine amidase, Neisseria meningitidis MC58, 181 residues	MSKIICLTAGHSNTDPGAVNGSDREADLAQDMRNIVASILRNDYGLTVKTDGTGKGNMPLRDAVKLIRGSDVAIEFHTNAAANKTATGIEALSTPKNKRWCQVLGKAVAKKTGWKLRGEDGFKPDNAGQHSRLAYAQAGGIVFEPFFISNDTDLALFKTTKWGICRAIADAIAMELGAAKV
>T0426 CA13A, Homo sapiens, 283 residues	MHHHHHHSSGVDLGTENLYFQSMSRLSWGYREHNGPIHWKEFFPIADGDQQSPIEIKTKEVKYDSSLRPLSIKYDPSSAKIISNSGHSFNVDFDDTENKSVLRGGPLTGSYRLRQVHLHWGSADDHGSEHIVDGVSYAAELHVVHWNSDKYPSFVEAAHEPDGLAVLGVFLQIGEPNSQLQKITDTLDSIKEKGKQTRFTNFDLLSLLPPSWDYWTYPGSLTVPPLLESVTWIVLKQPINISSQQLAKFRSLLCTAEGEAAAFLVSNHRPPQPLKGRKVRASF
>T0427 conserved hypothetical protein, Enterococcus faecalis V583, 422 residues	MSVQLVKGVNLHVIPTEKYKTVRLLVRFNTRLNHETITKRTLLSSLMETNSLNYPNQVKLSERLAELYGASFGIGVSKKGNQHWFNISMNIVNDHYLQDSQVLAEAVDFLKEIIFAPNIQAGQFEAETFQREKENLKAYLESIVEDKQTYASLALQSVYFNQSEDQKIPSFGTVAALAEETAASLAAYYQKMLAEDQVDIFVLGDVNEAELVPLFKQLPFTPREEGKAAIFYNQPIRNVIEERTEREVLAQSKLNLAYNTDIYYGDSYYFALQVFNGIFGGFPHSKLFMNVREKEHLAYYASSSIDTFRGFMTVQTGIDGKNRNQVLRLISTELENIRLGKIRELEIEQTKAMLKNQYILALDNAGAWLEKEYLNELMPQTMLTAEEWIARINAVTIPEIQEVAKRLELQAIFFLEGETEND
>T0428 Cp_pf11_0208, Cryptosporidium parvum, 267 residues	MGSSHHHHHHSSGLVPRGSTYKLTLIRHGESEWNKENRFTGWTDVSLSEQGVSEAIEAGRMLLEKGFKFDVVYTSVLKRAIMTTWTVLKELGNINCPIINHWRLNERHYGALQGLNKSETASKFGEDQVKIWRRSFDVPPPVLEKSDPRWPGNELIYKGICPSCLPTTECLKDTVERVKPYFEDVIAPSIMSGKSVLVSAHGNSLRALLYLLEGMTPEQILEVNIPTACPLVLELDDYLKVTKKYYLISEEELKAKMEAVANQGKAK
>T0429 SDC130H02, Homo sapiens, 178 residues	MHHHHHHSSGRENLYFQGMWDETELGLYKVNEYVDARDTNMGAWFEAQVVRVTRKAPSRDEPCSSTSRPALEEDVIYHVKYDDYPENGVVQMNSRDVRARARTIIKWQDLEVGQVVMLNYNPDNPKERGFWYDAEISRKRETRTARELYANVVLGDDSLNDCRIIFVDEVFKIERPGE
>T0430 GSG2A, Homo sapiens, 357 residues	MHHHHHHSSGVDLGTENLYFQSMGECSQKGPVPFSHCLPTEKLQRCEKIGEGVFGEVFQTIADHTPVAIKIIAIEGPDLVNGSHQKTFEEILPEIIISKELSLLSGEVCNRTEGFIGLNSVHCVQGSYPPLLLKAWDHYNSTKGSANDRPDFFKDDQLFIVLEFEFGGIDLEQMRTKLSSLATAKSILHQLTASLAVAEASLRFEHRDLHWGNVLLKKTSLKKLHYTLNGKSSTIPSCGLQVSIIDYTLSRLERDGIVVFCDVSMDEDLFTGDGDYQFDIYRLMKKENNNRWGEYHPYSNVLWLHYLTDKMLKQMTFKTKCNTPAMKQIKRKIQEFHRTMLNFSSATDLLCQHSLFK
>T0431 CYP7A1, Homo sapiens, 491 residues	MAKKTSSRRRQTGEPPLENGLIPYLGCALQFGANPLEFLRANQRKHGHVFTCKLMGKYVHFITNPLSYHKVLCHGKYFDWKKFHFATSAKAFGHRSIDPMDGNTTENINDTFIKTLQGHALNSLTESMMENLQRIMRPPVSSNSKTAAWVTEGMYSFCYRVMFEAGYLTIFGRDLTRRDTQKAHILNNLDNFKQFDKVFPALVAGLPIHMFRTAHNAREKLAESLRHENLQKRESISELISLRMFLNDTLSTFDDLEKAKTHLVVLWASQANTIPATFWSLFQMIRNPEAMKAATEEVKRTLENAGQKVSLEGNPICLSQAELNDLPVLDSIIKESLRLSSASLNIRTAKEDFTLHLEDGSYNIRKDDIIALYPQLMHLDPEIYPDPLTFKYDRYLDENGKTKTTFYCNGLKLKYYYMPFGSGATICPGRLFAIHEIKQFLILMLSYFELELIEGQAKCPPLDQSRAGLGILPPLNDIEFKYKFKHHHHHH
>T0432 ATAD2A, Homo sapiens, 130 residues	SMQEEDTFRELRIFLRNVTHRLAIDKRFRVFTKPVDPDEVPDYVTVIKQPMDLSSVISKIDLHKYLTVKDYLRDIDLICSNALEYNPDRDPGDRLIRHRACALRDTAYAIIKEELDEDFEQLCEEIQESR
>T0433 CAC97174 , Listeria innocua, 199 residues	MKILLIGASGTLGSAVKERLEKKAEVITAGRHSGDVTVDITNIDSIKKMYEQVGKVDAIVSATGSATFSPLTELTPEKNAVTISSKLGGQINLVLLGIDSLNDKGSFTLTTGIMMEDPIVQGASAAMANGAVTAFAKSAAIEMPRGIRINTVSPNVLEESWDKLEPFFEGFLPVPAAKVARAFEKSVFGAQTGESYQVY
>T0434 PRDM1, Homo sapiens, 205 residues	MGSSHHHHHHSSGLVPRGSKMDMEDADMTLWTEAEFEEKCTYIVNDHPWDSGADGGTSVQAEASLPRNLLFKYATNSEEVIGVMSKEYIPKGTRFGPLIGEIYTNDTVPKNANRKYFWRIYSRGELHHFIDGFNEEKSNWMRYVNPAHSPREQNLAACQNGMNIYFYTIKPIPANQELLVWYCRDFAERLHYPYPGELTMMNLTQ
>T0435 PRDM4, Homo sapiens, 151 residues	EHGPVTFVPDTPIESRARLSLPKQLVLRQSIVGAEVGVWTGETIPVRTCFGPLIGQQSHSMEVAEWTDKAVNHIWKIYHNGVLEFCIITTDENECNWMMFVRKARNREEQNLVAYPHDGKIFFCTSQDIPPENELLFYYSRDYAQQIGVPE
>T0436 CAE48762, Corynebacterium diphtheriae, 419 residues	MSLKDYDAARLAQVREEVTAKYAELKAKNLSLDLTRGKPSAEQLDLSNDLLSLPGGDFRTKDGVDCRNYGGLLGIADIRELWAEALGLPADLVVAQDGSSLNIMFDLISWSYTWGNNDSSRPWSAEEKVKWLCPVPGYDRHFTITEHFGFEMINVPMTDEGPDMGVVRELVKDPQVKGMWTVPVFGNPTGVTFSEQTCRELAEMSTAAPDFRIVWDNAYALHTLSDEFPIVHNVIEFAQAAGNPNRFWFMSSTSKITHAGSGVSFFASSKENIEWYASHANVRGIGPNKLNQLAHAQFFGDVAGLKAHMLKHAASLAPKFERVLEILDSRLSEYGVAKWTSPTGGYFISVDVVPGTASRVVELAKEAGIALTGAGSSFPLHNDPNNENIRLAPSLPPVAELEVAMDGFATCVLMAALEV
>T0437 SfR90 , Shigella flexneri, 99 residues	MKDVVDKCSTKGCAIDIGTVIDNDNCTSKFSRFFATREEAESFMTKLKELAAAASSADEGASVAYKIKDLEGQVELDAAFTFSCQAEMIIFELSLRSLA
>T0438 PgR26_I192G, PORPHYROMONAS GINGIVALIS, 439 residues	MQWQELYRQRVCSADEAVVDSLKPGTKVVFGHAAAAPVRFSQAMYRQREKLENITVFHMLYFGDAPHLAPEMRSHVHPTLNFLEGNSRPASRDRRVDFIPCHFHEVPELFRQGFFPLDVAVVQVSTPNEEGYCSFGVSCDYTKAAAECAPVVVAEVNKQMPFIGGENLIHISKLTHIIEVDEPIAEVLPPAGSDLELRIGQNCASLIKDGDTLQLGIGGIPDAVLRALEGHKDLGIHTEMFTDGVMRMIRKGIINGKKKTLHPEKVVTSLIFGSKELYDFVNNNPVIECYPVDYINNPDVIGKNDRMVSINSCLEMDLMGQAASESIGYEQFSGSGGQVDFLRGAKRSKGGISIMAFPSTAKKGTESRIVPILKEGACVTTGRNEVDYVVTEYGVARLRGATLRQRAEALTAIAHPDFRPALEEEIRRRFELEHHHHHH
>T0439 TrpR binding protein WrbA, Agrobacterium tumefaciens str. C58, 223 residues	MIIEFLKKLLAGTPETVPAKETKRMTKVLVLYYSSYGHIETMAYAVAEGVESTGAEAVVKRVPELVPEEVAKSSHFKMDQPAPVATVDELAEYDAIIVGAGTRFGTVASQMRNFWDQTGGLWFSGKLVGKVGSAFTSSATQHGGQESTILGFIPTFLHHGMAVVGLPYAFQGQMGVDEIKGGSPYGASTITDGDGSRQPSAIELDAARYQGAHVAKLAAKLSA
>T0440 Q4EIC3_LISMO, Listeria monocytogenes, 275 residues	MKRDGHTHTEFCPHGTHDDVEEMVLKAIELDFDEYSIVEHAPLSSEFMKNTAGDKEAVTTASMAMSDLPYYFKKMNHIKKKYASDLLIHIGFEVDYLIGYEDFTRDFLNEYGPQTDDGVLSLHFLEGQGGFRSIDFSAEDYNEGIVQFYGGFEQAQLAYLEGVKQSIEADLGLFKPRRMGHISLCQKFQQFFGEDTSDFSEEVMEKFRVILALVKKRDYELDFNTAGLFKPLCGETYPPKKIVTLASELQIPFVYGSDSHGVQDIGRGYSTYCQK
>T0441 NP_799742, Vibrio parahaemolyticus, 342 residues	MSEPRKRRSTGNVTLADVAKQAGVGTMTVSRALRTPELVSDKLREKIQQVVDELGYIPNKAAGALASAESYSIALIIPSLFEKACAHFLPSFQQALNKAGYQLLLGYSDYSIEQEEKLLSTFLESRPAGVVLFGSEHSQRTHQLLEASNTPVLEIAELSSKASYLNIGVDHFEVGKACTRHLIEQGFKNVGFIGARGNHSTLQRQLHGWQSAMIENYLTPDHFLTTHEAPSSQLGAEGLAKLLLRDSSLNALVCSHEEIAIGALFECHRRVLKVPTDIAIICLEGSSMGEHAYPSLTSAEFDYERMGTKAAEKLLHAIKGEPEERPTSMGFKLKRRASTAIN
>T0442 Atu3911 , Agrobacterium tumefaciens, 269 residues	MTIPTSYLNHTDAEAARKARATYRDGLVAPTSGIAPGFTQANMIVLPRDWAFDFLLYAQRNPKPCPVLDVSDPGSPTTLLAPGADLRTDLPLYRIWRDGKLAEETADATSAWAERDDLVAFLIGCSFTFETPMVEAGIEIRHMTDKSNVPMYLTNRPCRPAGRLKGNMVVSMRPIPASRVADAATISGRFPAVHGAPVHVGAPEQIGISDLSKPDFGDAVRIEPGEVPVFWACGVTPQAAVMASGVPFAITHAPGHMFITDIPDTAYHA
>T0443 FP12834A, Neisseria gonorrhoeae, 248 residues	MQPETSAQYQHRFSQAIRGGEAADGLPQDRLNVYIRLIRNNIHSFIDRCYTETRQYFDSKEWSRLKEGFVRDARAQTPYFQEIPGEFLQYCQSPPLSDGILALMDFEYTQLLAEVAQIPDIPDIHYSNDSKYTPSPAAFIRQYRYDVTHDLQEAETALLIWRNAEDDVMYQTLDGFDMMLLEIMGSSALSFDTLAQTLVEFMPKADNWKNILLGKWSGWIEQRIIIPSLSAISENMEGNSPSQNHLSA
>T0444 MM30C, Homo sapiens, 326 residues	MHHHHHHSSGVDLGTENLYFQSMSDTNESEIKSNEEPLLRKSSRRFVIFPIQYPDIWKMYKQAQASFWTAEEVDLSKDLPHWNKLKADEKYFISHILAFFAASDGIVNENLVERFSQEVQVPEARCFYGFQILIENVHSEMYSLLIDTYIRDPKKREFLFNAIETMPYVKKKADWALRWIADRKSTFGERVVAFAAVEGVFFSGSFAAIFWLKKRGLMPGLTFSNELISRDEGLHCDFACLMFQYLVNKPSEERVREIIVDAVKIEQEFLTEALPVGLIGMNCILMKQYIEFVADRLLVELGFSKVFQAENPFDFMENISLEGKTN
>T0445 GD4050C, unknown, 264 residues	MIKLIATDIDGTLVKDGSLLIDPEYMSVIDRLIDKGIIFVVCSGRQFSSEFKLFAPIKHKLLYITDGGTVVRTPKEILKTYPMDEDIWKGMCRMVRDELPACDYFAATPDFCFAEDGGSPIFHLLRDSYGFEMREVDDITRLDRNDIIKFTVFHPDKCEELCTPVFIPAWNKKAHLAAAGKEWVDCNAKGVSKWTALSYLIDRFDLLPDEVCCFGDNLNDIEMLQNAGISYAVSNARQEVIAAAKHTCAPYWENGVLSVLKSFL
>T0446 YP_001092950.1, Shewanella loihica, 124 residues	MGLLDALMGNAAEVNLDELAQELGPIMGDNEQLALAYRVIRDMFVFTNKRLILIDKQGVTGKKVSYHSVPYKAITHFEVETAGTFDMDAELKLWISGQKDPLVKELKKGTDVVGIQKTIANFSL
>T0447 TM1766, Formate--tetrahydrofolate ligase, Thermotoga maritima, 542 residues	MKPIKEIADQLELKDDILYPYGHYIAKIDHRFLKSLENHEDGKLILVTAVTPTPAGEGKTTTSIGLSMSLNRIGKKSIVTLREPSLGPTLGLKGGATGGGRSRVLPSDEINLHFTGDMHAVASAHNLLAAVLDSHIKHGNELKIDITRVFWKRTMDMNDRALRSIVIGLGGSANGFPREDSFIITAASEVMAILALSENMKDLKERLGKIIVALDADRKIVRISDLGIQGAMAVLLKDAINPNLVQTTEGTPALIHCGPFANIAHGTNSIIATKMAMKLSEYTVTEAGFGADLGAEKFIDFVSRVGGFYPNAAVLVATVRALKYHGGANLKNIHEENLEALKEGFKNLRVHVENLRKFNLPVVVALNRFSTDTEKEIAYVVKECEKLGVRVAVSEVFKKGSEGGVELAKAVAEAAKDVEPAYLYEMNDPVEKKIEILAKEIYRAGRVEFSDTAKNALKFIKKHGFDELPVIVAKTPKSISHDPSLRGAPEGYTFVVSDLFVSAGAGFVVALSGDINLMPGLPKKPNALNMDVDDSGNIVGVS
>T0448 Q88SR8, Lactobacillus plantarum, 232 residues	MIAMIVKGGLAMAISNGHVSFKRPAWLGDSITANNGLATVHYHDILAADWDVERSDNLGISGSTIGSRYDAMAVRYQAIPEDADFIAVFGGVNDYGRDQPLGQYGDCDMTTFYGALMMLLTGLQTNWPTVPKLFISAIHIGSDFGGSFSAVTNGLGYRQSDYEAAIAQMTADYGVPHLSLYRDAGMTFAIPAQAAIYSVDTLHPNNAGHRVIARKLQSFLDSHFLEHHHHHH
>T0449 Galactose mutarotase related enzyme Q5FKD7, Lactobacillus acidophilus, 307 residues	MDYTIENNMIKVVISDHGAEIQSVKSAHTDEEFMWQANPEIWGRHAPVLFPIVGRLKNDEYTYKGKTYHLGQHGFARNADFEVENHTKESITFLLKDNEETRKVYPFKFEFRVNYNLMNNLLEENFSVVNKSDETMIFGVGGHPGFNLPTDHGENKEDFYFDMHPSVTRVRIPLKDASLDWNNRSLAPTDSLIALSDDLFKDDALIYELRGNDNKVSLRTDKNKFHVNVWTRDAPFVGIWSQYPKTDNYVCIEPWWGIADRDDADGDLEHKYGMNHLKPGKEFQAGFSMTYHSTTDEVKLEHHHHHH
>T0450 Glycerol-3-phosphate dehydrogenase, Bacillus halodurans, 561 residues	MFSAKKRDKCIGEMSEKQLDLLVIGGGITGAGIALDAQVRGIQTGLVEMNDFASGTSSRSTKLVHGGLRYLKQFEIKLVAEVGKERAIVYENAPHVTTPEWMLLPIFKDGTFGKFSTSLGLKVYDYLADVRKDERRYMLNEKQTLEKEPLLRKENLKGGGIYVEYRTDDARLTLEIMKEAVARGAVALNYMKVESFIYDQGKVVGVVAKDRLTDTTHTIYAKKVVNAAGPWVDTLREKDRSKHGKYLKLSKGVHLVVDQSRFPLRQAVYFDTESDGRMIFAIPREGKTYIGTTDTFYDKDIASPRMTVEDRDYILAAANYMFPSLNLTADDVESSWAGLRPLIHEEGKKASEISRKDEIFFSDSGLISIAGGKLTGYRKMAERTVDAVAQGLNVNEPCTTAAIRLSGGLAEGAQGFPRFLDEASRKGAKLGFDADEVRRLAKLYGSNVDHVLNYAYEGKEEAEHYGLPALLLGQLQYGVEQEMVATPLDFFVRRTGALFFNISLVHQWKEAVLRWMAEEFSWTEEEKTRFQNELETELKMAVDPLFQVEPTTVLEHHHHHH
>T0451 YP_322774.1, Anabaena variabilis, 133 residues	MMTHYSDNTLKVAHQGFEFFTQGLATGEWQKFLDMLTEDFTFWFPMGEFHGLNVGKERAKEFFTYVSESFHTGIQISSLDRVTSNETTVVFEFRDEGLFLGKPYKNRVAVSFDVRGDKICSYREYFGSDGKSN
>T0452 NP_069768.1, ARCHAEOGLOBUS FULGIDUS, 326 residues	MIKIAIVGFGTVGQGVAELLIRKREEIEKAIGEFKVTAVADSKSSISGDFSLVEALRMKRETGMLRDDAKAIEVVRSADYDVLIEASVTRVDGGEGVNYIREALKRGKHVVTSNKGPLVAEFHGLMSLAERNGVRLMYEATVGGAMPVVKLAKRYLALCEIESVKGIFNGTCNYILSRMEEERLPYEHILKEAQELGYAEADPSYDVEGIDAALKLVIIANTIGVKASYEDVEVTGITQITPEAFQVAAEKGYTIRLIAEVSREKLKVSPRLVPFHHPLAIKGTMNAAMFKTDTAGSIFVAGRGAGKEETASAILSDLYEIYAGPR
>T0453 C-terminal domain of Probable hemolysin , Chromobacterium violaceum , 91 residues	DGEEDEIVQREDGSWLVDGMVSLDRFREFFELEAPLPGEAGGNIHTLAGVMLYQLGRVPSVTDRFEWNGFSFEVVDMDRTRVDKILVQRHH
>T0454 transcriptional regulator, TetR family, Geobacter sulfurreducens PCA, 203 residues	MTRADCRSRLMEVATELFAQKGFYGVSIRELAQAAGASISMISYHFGGKEGLYAAVLQEQFACFGQLDDIRGQAGDPLAVMTAYLRWTIQRHRNNPQLLRFYTSELTNPTPCFAAIVSPAIASVIRLLAESIEAGMTRGLFRRDLHAVNSALALAGMVNYFFLSTLATEGLTSHSPDQDEELIRQYVAIFTRGIMADGGAAPA
>T0455 APC85201, transcriptional regulator, Enterococcus faecalis V583, 145 residues	SQNRVPSSRTVSYFVAKPSSSEMEKLQLGPEDSILRMERIRFADDIPICFEVASIPYSLVSQYGKSEITNSFYKTLEAKSGHKIGHSNQTISAVQASEQIAEYLEIKRGDAILRVRQVSYFENGLPFEYVRTQYAGSRFEFYLEK
>T0456 cgd3_920, Cryptosporidium parvum, 286 residues	MHHHHHHSSGRENLYFQGTFAERYNIVCMLGKGSFGEVLKCKDRITQQEYAVKVINKASAKNKDTSTILREVELLKKLDHPNIMKLFEILEDSSSFYIVGELYTGGELFDEIIKRKRFSEHDAARIIKQVFSGITYMHKHNIVHRDLKPENILLESKEKDCDIKIIDFGLSTCFQQNTKMKDRIGTAYYIAPEVLRGTYDEKCDVWSAGVILYILLSGTPPFYGKNEYDILKRVETGKYAFDLPQWRTISDDAKDLIRKMLTFHPSLRITATQCLEHPWIQKYSSE
>T0457 SH1221, Staphylococcus haemolyticus, 320 residues	MVEIFNEIMQRVKEAETIIIHRHVRPDPDAYGSQLGLKLYLERKFPEKNIYATGEAEPSLSFIGDLDEIDDSVYSDALVIVCDTANAPRIDDQRYLNGQSLIKIDHHPATDQYGDVNFVNTEASSTSEIIFDFISHFNDLSIIDEHVARVLYLGIVGDTGRFLFSNTSPHTMEVASQLLAYPFNHNAELNKMSEKDPKLMPFQGYVLQNFELSDSHEYCQIKITNDVLKQFDIQPNEASQFVNTVADISGLKIWMFGVDEGDQIRCRIRSKGITINDVANQFGGGGHPNASGVSVYSWDEFEELAQALRQKLLEHHHHHH
>T0458 SAV_2001, Streptomyces avermitilis, 107 residues	MVGAPRMTTPHTHRVQIEYCTQCRWLPRAAWLAQELLTTFETELTELALKPGTGGVFVVRVDDEVVWDRREQGFPEPTAVKRLVRDRVAPEKSLGHSERLEHHHHHH
>T0459 APC89000, Thermoplasma volcanium, 111 residues	SNAMLRYGDTEICIDPSESVLHLLGKKYTMLIISVLGNGSTRQNFNDIRSSIPGISSTILSRRIKDLIDSGLVERRSGQITTYALTEKGMNVRNSLMPLLQYISVLDRNGD
>T0460 PF0246, Pyrococcus furiosus, 111 residues	MNSEVIKEFLEDIGEDYIELENEIHLKPEVFYEVWKYVGEPELKTYVIEDEIVEPGEYDPPEMKYTNVKKVKIKKVYFETLDNVRVVTDYSEFQKILKKRGTKLEHHHHHH
>T0461 DEAD1CA, Homo sapiens, 189 residues	MHHHHHHSSGVDLGTENLYFQSMEETEKWMEEAMHMAKEALENTEVPVGCLMVYNNEVVGKGRNEVNQTKNATRHAEMVAIDQVLDWCRQSGKSPSEVFEHTVLYVTVEPCIMCAAALRLMKIPLVVYGCQNERFGGCGSVLNIASADLPNTGRPFQCIPGYRAEEAVEMLKTFYKQENPNAPKSKVRK
>T0462 VR131 , Thermotoga maritima MSB8, 154 residues	MKLSRLVPGVPARIKRLEVSGELHEKLVGMGFVPGEEIEIVQVAPLGDPIVCKIGNRNITLRKREADLIEVEVVGGELPLILADDGTYEITKLNGGRRFLFRMKNLGIESGKKIQVSGRRYYIEGREIDLGYGEATKIWVRRVSDAGEESHPQK
>T0463 Q89Z24_BACTN, Bacteroides thetaiotaomicron, 219 residues	MEKVKKIVLIGASGFVGSALLNEALNRGFEVTAVVRHPEKIKIENEHLKVKKADVSSLDEVCEVCKGADAVISAFNPGWNNPDIYDETIKVYLTIIDGVKKAGVNRFLMVGGAGSLFIAPGLRLMDSGEVPENILPGVKALGEFYLNFLMKEKEIDWVFFSPAADMRPGVRTGRYRLGKDDMIVDIVGNSHISVEDYAAAMIDELEHPKHHQERFTIGY
>T0464 XfR39, Xylella fastidiosa 9a5c, 89 residues	MDRKLLHLLCSPDTRQPLSLLESKGLEALNKAIASGTVQRADGSIQNQSLHEALITRDRKQVFRIEDSIPVLLPEEAIATIQIANFPDK
>T0465 yqbN, Bacillus subtilis, 157 residues	MSENQNEKVYDLSFFMPGQTIDAEEVEVPISKRFVDKEGNVVPFIFKAITTDRIDELEKENTTYKNVKGRGRVKELDSQRFYARIAVETTVYPTFKAKELREAYKTEDPVEVAKRVLSVGGEYANWLNKAIEINGFDDDLEDLEEAAKNLEHHHHHH
>T0466 SaR32, Streptococcus agalactiae, 128 residues	MMRLANGIVLDKDTTFGELKFSALRREVRIQNEDGSVSDEIKERTYDLKSKGQGRMIQVSIPASVPLKEFDYNARVELINPIADTVATATYQGADVDWYIKADDIVLTKDSSSFKAQPQAKKEPTQDK
>T0467 BcR97A, Bacillus cereus, 97 residues	MDLNRMGKDEYYVQITVDGKEVHSKADNGQKYKDYEYKLTGFDKDGKEKELEFTAQKNLRKEAFLRVYHSDKKGVSAWEEVKKDELPAKVKEKLGVK
>T0468 BcR103A, Bacillus cereus, 109 residues	MERASLNRIGKDVYYMQIKGEGTIEKVDGRNLRNYTLPAYDEDGVKKQITFRSTKKENDHKLNKYAFLRLYVDQDDNSKNEISSIEVKSYEEIQKADLPEKVKDKFTIK
>T0469 GsR195, Geobacter sulfurreducens PCA, 65 residues	MTQKFTKDMTFAQALQTHPGVAGVLRSYNLGCIGCMGAQNESLEQGANAHGLNVEDILRDLNALA
>T0470 BT9727_1981, Bacillus thuringiensis, 223 residues	MTKQEKIEKTITFVKHILEKDASGHDWYHIRRVHKMAISLSEQEGGNRFIIEMAALLHDVADEKLNESEEAGMKKVSDWLEELHVEEEESKHVLHIIANMSYKGGHGGKVESIEGKLVQDADRLDALGAIGIARTFAYGGAKGRLMYDPTIPPREVMTKDEYRKNNDPSLNHFYEKLLKLKDLMNTNAAKQEAEVRHRYMEQFIEQFMKEWNAQILEHHHHHH
>T0471 TR8, Methanothermobacter thermautotrophicus, 133 residues	MWNDLAVYIIRCSGPGTRVVEVGAGRFLYVSDYIRKHSKVDLVLTDIKPSHGGIVRDDITSPRMEIYRGAALIYSIRPPAEIHSSLMRVADAVGARLIIKPLTGEDIVTERKMKLVNYGRTYFYEYIAEVRSR
>T0472 SoR190, Shewanella oneidensis MR-1, 110 residues	MSGWYELSKSSNDQFKFVLKAGNGEVILTSELYTGKSGAMNGIESVQTNSPIEARYAKEVAKNDKPYFNLKAANHQIIGTSQMYSSTAARDNGIKSVMENGKTTTIKDLT
>T0473 CmR9, Clostridium thermocellum, 68 residues	MKITKDMIIADVLQMDRGTAPIFINNGMHCLGCPSSMGESIEDACAVHGIDADKLVKELNEYFEKKEV
>T0474 SfT1, Shigella flexneri, 80 residues	MNSLAGIDMGRILLDLSNEVIKQLDDLEVQRNLPRADLLREAVDQYLINQSQTARTSVPGIWQGCEEDGVEYQRKLREEW
>T0475 AtT8, unknown, 122 residues	LNSEIELPVQKQLEAYNARDIDAFMAWWADDCQYYAFPATLLAGNAAEIRVRHIERFKEPDLYGELLTRVIVGNVVIDHETVTRNFPEGKGEVDVACIYEVENGRIAKAWFKIGEPRIVSQK
>T0476 PfG1, Pyrococcus furiosus, 108 residues	SAKCPICGSPLKWEELIEEMLIIENFEEIVKDRERFLAQVEEFVFKCPVCGEEFYGKTLPRREAEKVFELLNDFKGGIDWENKRVKLKLNDLLALETMLEEWDRRVKR
>T0477 DDX52A, Homo sapiens, 242 residues	SMKINFLRNKHKIHVQGTDLPDPIATFQQLDQEYKINSRLLQNILDAGFQMPTPIQMQAIPVMLHGRELLASAPTGSGKTLAFSIPILMQLKQPANKGFRALIISPTRELASQIHRELIKISEGTGFRIHMIHKAAVAAKKFGPKSSKKFDILVTTPNRLIYLLKQDPPGIDLASVEWLVVDESDKLFEDGKTGFRDQLASIFLACTSHKVRRAMFSATFAYDVEQWCKLNLDNVISVSIGA
>T0478 Hypothetical protein, Bacillus cereus, 283 residues	MSLDTGVTSVMFVERSLNEIRFWSRIMKEHSFFLRLGFRCEDTQLIEEANQFYRLFEHIEQIAHSYTNETDPEQIKRFNAEVQQAATNIWGFKRKILGLILTCKLPGQNNFPLLVDHTSREADYFRKRLIQLNEGKLDALPDAIIKENVFFLRIMADHAKFIGHLLDPSERKLVDTARNFSNDFDELMYQAIDLESMKPQSQTAPLLDQFLDQNRVSVASLRDFKKTARDLIEQCKIKSIIHPLLADHVFREADRFLEIIDMYDVHLTNIQSQPREGHHHHHH
>T0479 Q7W9W5_BORPA, Bordetella parapertussis, 134 residues	MSTPHTDFFGLTIPFMQLLGVVPEHSGNGTARTRLPARADLVNSRGDIHGGTLMSVLDFTLGAAIRGDTPEVGVATIDMNTSFMSPGRGDLVIETRCLRRGASIAFCEGEIRDSAGELVAKATATFKIIQRRPG
>T0480 TaT88, Thermoplasma acidophilum, 55 residues	MQKRELYEIADGKLVRKHRFCPRCGPGVFLAEHADRYSCGRCGYTEFKKAKKSKS
>T0481 NP_389123.1, Bacillus subtilis, 154 residues	MCQSNQIVSHFLSHRNVTNELAEKISKDHYSYKPAETSMSAEELVKHILTSFHLFANVIKEGNASPFQNKQEETETDLNVLAKTYTEKTVAILEQLTEEQLDREIDLTSAFGRKVTGRALLQLAMEHEIHHKGNLFVYVREMGHTELPFYQQRM
>T0482 PaT3, Pseudomonas aeruginosa, 120 residues	MFEPGHLHLVSLPGLDQQDINIHIRYEVRQNAESGAYVHFDMDGEIDGKPFSDSFELPRDTAFNFASDATRVAQKHGLHPKFGAITRVHKEYDAMFEDIRAKLHAHPGEPVDLERIIRHE
>T0483 PAS kinase, Human, 335 residues	MALEEPPKAVELEGLAACEGEYSQKYSTMSPLGSGAFGFVWTAVDKEKNKEVVVKFIKKEKVLEDCWIEDPKLGKVTLEIAILSRVEHANIIKVLDIFENQGFFQLVMEKHGSGLDLFAFIDRHPRLDEPLASYIFRQLVSAVGYLRLKDIIHRDIKDENIVIAEDFTIKLIDFGSAAYLERGKLFYTFCGTIEYCAPEVLMGNPYRGPELEMWSLGVTLYTLVFEENPFCELEETVEAAIHPPYLVSKELMSLVSGLLQPVPERRTTLEKLVTDPWVTQPVNLADYTWEEVFRVNKPESGVLSAASLEMGNRSLSDVAQAQELCGGEGHHHHHH
>T0484 RhR2, Rhodobacter sphaeroides, 62 residues	MRDMTEETRKDLPPEALRALAEAEERRRRAKALDLPKEIGGRNGPEPVRFGDWEKKGIAIDF
>T0485 Putative S-adenosyl-L-methionine-dependent Methyltransferase, Methanococcus maripaludis, 218 residues	MSENKKKFDKKGAKNMDEISKTLFAPIYPIIAENIINRFGITAGNCIDIGSGPGALSIALAKQSDFSIRALDFSKHMNEIALKNIADADLNDRIQIVQGDVHNIPIEDNYADLIVSRGSVFFWEDVTTAFREIYRILKSGGKTYIGGGFGNKELRDSISAEMIRKNPDWKEFNRKNISQENVERFQNVLDEIGVSSYEIILEDEGFWIIISKTDQEVI
>T0486 ECHDC3A , Homo sapiens, 287 residues	MHHHHHHSSGVDLGTENLYFQSMGAGRRESEPRPTSARQLDGIRNIVLSNPKKRNTLSLAMLKSLQSDILHDADSNDLKVIIISAEGPVFSSGHDLKELTEEQGRDYHAEVFQTCSKVMMHIRNHPVPVIAMVNGLATAAGCQLVASCDIAVASDKSSFATPGVNVGLFCSTPGVALARAVPRKVALEMLFTGEPISAQEALLHGLLSKVVPEAELQEETMRIARKIASLSRPVVSLGKATFYKQLPQDLGTAYYLTSQAMVDNLALRDGQEGITAFLQKRKPVWSH
>T0487 Argonaute protein silencing complex, Thermus thermophilus, 685 residues	MNHLGKTEVFLNRFALRPLNPEELRPWRLEVVLDPPPGREEVYPLLAQVARRAGGVTVRMGDGLASWSPPEVLVLEGTLARMGQTYAYRLYPKGRRPLDPKDPGERSVLSALARRLLQERLRRLEGVWVEGLAVYRREHARGPGWRVLGGAVLDLWVSDSGAFLLEVDPAYRILCEMSLEAWLAQGHPLPKRVRNAYDRRTWELLRLGEEDPKELPLPGGLSLLDYHASKGRLQGREGGRVAWVADPKDPRKPIPHLTGLLVPVLTLEDLHEEEGSLALSLPWEERRRRTREIASWIGRRLGLGTPEAVRAQAYRLSIPKLMGRRAVSKPADALRVGFYRAQETALALLRLDGAQGWPEFLRRALLRAFGASGASLRLHTLHAHPSQGLAFREALRKAKEEGVQAVLVLTPPMAWEDRNRLKALLLREGLPSQILNVPLREEERHRWENALLGLLAKAGLQVVALSGAYPAELAVGFDAGGRESFRFGGAACAVGGDGGHLLWTLPEAQAGERIPQEVVWDLLEETLWAFRRKAGRLPSRVLLLRDGRVPQDEFALALEALAREGIAYDLVSVRKSGGGRVYPVQGRLADGLYVPLEDKTFLLLTVHRDFRGTPRPLKLVHEAGDTPLEALAHQIFHLTRLYPASGFAFPRLPAPLHLADRLVKEVGRLGIRHLKEVDREKLFFV
>T0488 LNX2A@3, Homo sapiens, 95 residues	SMEILQVALHKRDSGEQLGIKLVRRTDEPGVFILDLLEGGLAAQDGRLSSNDRVLAINGHDLKYGTPELAAQIIQASGERVNLTIARPGKPEIEL
>T0489 Putative Metal-dependent Hydrolase, Klebsiella pneumoniae, 266 residues	MMFKWPWKADDESGNAEMPWEQALAIPVLAHLSSTEQHKLTQMAARFLQQKRLVALQGLELTPLHQARIAMLFCLPVLELGIEWLDGFHEVLIYPAPFIVDDEWEDDIGLVHNQRVVQSGQSWQQGPVVLNWLDIQDSFDASGFNLVVHEVAHKLDTRNGDRASGVPLIPLREVAGWEHDLHAAMNNIQDEIDLVGESAASIDAYAATDPAECFAVLSEYFFSAPELFAPRFPALWQRFCHFYRQDPLARRRENGLQDEGDRRIVH
>T0490 BeR141, Bordetella pertussis, 369 residues	MSTDIDCIVIGAGVVGLAIARALAAGGHEVLVAEAAEGIGTGTSSRNSEVIHAGIYYPADSLKARLCVRGKHLLYEYCAARGVPHQRLGKLIVATSDAEASQLDSIARRAGANGVDDLQHIDGAAARRLEPALHCTAALVSPSTGIVDSHALMLAYQGDAESDGAQLVFHTPLIAGRVRPEGGFELDFGGAEPMTLSCRVLINAAGLHAPGLARRIEGIPRDSIPPEYLCKGSYFTLAGRAPFSRLIYPVPQHAGLGVHLTLDLGGQAKFGPDTEWIATEDYTLDPRRADVFYAAVRSYWPALPDGALAPGYTGIRPKISGPHEPAADFAIAGPASHGVAGLVNLYGIESPGLTASLAIAEETLARLAA
>T0491 Primosomal replication protein, Bordetella pertussis, 115 residues	MNTLELSARVLECGAMRHTPAGLPALELLLVHESEVVEAGHPRRVELTISAVALGDLALLLADTPLGTEMQVQGFLAPARKDSVKVKLHLQQARRIAGSMGRDPLVGLEHHHHHH
>T0492 CmR17, Clostridium thermocellum, 73 residues	MFSLRDAKCGQTVKVVKLHGTGALKRRIMDMGITRGCEIYIRKVAPLGDPIQINVRGYELSLRKSAAEMIEVE
>T0493 DNA helicase APC89291.2, Lactobacillus plantarun, 174 residues	SNASYRSTQQITDFTKEILVNGEAVTAFDRQGDLPNVVVTPNFEAGVDQVVDQLAMNDSERDTTAIIGKSLAECEALTKALKARGEQVTLIQTENQRLAPGVIVVPSFLAKGLEFDAVIVWNANQENYQREDERQLLYTICSRAMHELTLVAVGSLSPLLARVNHALYTLNEAK
>T0494 DYRK1AA, Homo sapiens, 382 residues	MHHHHHHSSGVDLGTENLYFQSMSSHKKERKVYNDGYDDDNYDYIVKNGEKWMDRYEIDSLIGKGSFGQVVKAYDRVEQEWVAIKIIKNKKAFLNQAQIEVRLLELMNKHDTEMKYYIVHLKRHFMFRNHLCLVFEMLSYNLYDLLRNTNFRGVSLNLTRKFAQQMCTALLFLATPELSIIHCDLKPENILLCNPKRSAIKIVDFGSSCQLGQRIYQYIQSRFYRSPEVLLGMPYDLAIDMWSLGCILVEMHTGEPLFSGANEVDQMNKIVEVLGIPPAHILDQAPKARKFFEKLPDGTWNLKKTKDGKREYKPPGTRKLHNILGVETGGPGGRRAGESGHTVADYLKFKDLILRMLDYDPKTRIQPYYALQHSFFKKTADE
>T0495 SPO1766 protein of unknown function, Silicibacter pomeroyi, 150 residues	MPMTLDLQPGQRLARGVARHLRAHGFVSVEEFVPARGLRVDVMGLGPKGEIWVIECKSSRADFQADAKWQGYLEWCDRYFWAVDMEFPAELLPAESGLLIADAYDAEIVRMAPEQKLAPARRKVLIQKFATHAARRLQALRDPEGHGIFE
>T0496 hypothetical protein, Bacillus anthracis, 178 residues	MNTPVSVNEKKDFVKWFLNNYQLKQRECVWILNYLMSHDQLMHKVHFVEHAKYCPRGLVMSANCVKDTPFHFFKQNVMTTDAEKSFHDIRLNRDEDIYIQLNFKSSFQNANYVAVLEENPYLPKHIEVNEKDRLLAERFLEESVFSFRRERLLKQIDEALDKQDKEAFHRLTAELKML
>T0497 NP_637619.1, XANTHOMONAS CAMPESTRIS, 146 residues	MADPKELQDKFWKALKSDRTVMLGLDGVEDGHARPMTAQIEGDSGGPIWFFTSKDNALIAMLGQGRRVIGAFSSKGHDLFASISGSLREDTDPAVVDRLWNPYVAAWYEGGKDDPKLALLRLDADHAQIWLNGSSLLAGIKVLLGV
>T0498 L1c, E coli, 56 residues	TTYKLILNLKQAKEEAIKELVDAGTAEKYIKLIANAKTVEGVWTLKDEIKTFTVTE
>T0499 L1d, E coli, 56 residues	TTYKLILNLKQAKEEAIKEAVDAGTAEKYFKLIANAKTVEGVWTYKDEIKTFTVTE
>T0500 CSKI1_HUMAN Caskin-1, Human, 829 residues	AELQKAEYAKYEGGPLRRKAPQSLEVMAIESPPPPEPTPADCQSPKMTTFQDSELSDELQAAMTGPAEVGPTTEKPSSHLPPTPRATTRQDSSLGGRARHMSSSQELLGDGPPGPSSPMSRSQEYLLDEGPAPGTPPREARPGRHGHSIKRASVPPVPGKPRQVLPPGTSHFTPPQTPTKTRPGSPQALGGPHGPAPATAKVKPTPQLLPPTERPMSPRSLPQSPTHRGFAYVLPQPVEGEVGPAAPGPAPPPVPTAVPTLCLPPEADAEPGRPKKRAHSLNRYAASDSEPERDELLVPAAAGPYATVQRRVGRSHSVRAPAGADKNVNRSQSFAVRPRKKGPPPPPPKRSSSALASANLADEPVPDAEPEDGLLGVRAQCRRASDLAGSVDTGSAGSVKSIAAMLELSSIGGGGRAARRPPEGHPTPRPASPEPGRVATVLASVKHKEAIGPGGEVVNRRRTLSGPVTGLLATARRGPGESADPGPFVEDGTGRQRPRGPSKGEAGVEGPPLAKVEASATLKRRIRAKQNQQENVKFILTESDTVKRRPKAKEREAGPEPPPPLSVYHNGTGTVRRRPASEQAGPPELPPPPPPAEPPPTDLAHLPPLPPPEGEARKPAKPPVSPKPVLTQPVPKLQGSPTPTSKKVPLPGPGSPEVKRAHGTPPPVSPKPPPPPTAPKPVKAVAGLPSGSAGPSPAPSPARQPPAALAKPPGTPPSLGASPAKPPSPGAPALHVPAKPPRAAAAAAAAAAAPPAPPEGASPGDSARQKLEETSACLAAALQAVEEKIRQEDAQGPRDSAAEKSTGSILDDIGSMFDDLADQLDAMLE
>T0501 Exopolyphosphatase-related protein, Bacteroides fragilis, 343 residues	MLTKVIAQAHIDHFTKWFERADKIVIVSHVSPDGDAIGSSLGLYHFLDSQDKIVNVIVPNAFPDFLKWMPGSKDILLYDRYQEFADKLIMEADVICCLDFNALKRIDEMSDIVAASPGRKIMIDHHLYPEDFCRITISHPEISSTSELVFRLICRMGYFSDISKEGAECIYTGMMTDTGGFTYNSNNREIYFIISELLSKGIDKDDIYRKVYNTYSESRLRLMGYVLSNMKVYKDYNSALISLTKEEQGKFDYIKGDSEGFVNIPLSIKNVCFSCFLREDTEKKMIKISLRSVGKFPCNRLAAEFFNGGGHLNASGGEFYGTMEEAVKVFEQALEKYKPLLKE
>T0502 MjR118E, Methanocaldococcus jannaschii, 105 residues	EIKDTYNIGELSPGMTATFEGEVISALPIKEFKRADGSIGKLKSFIVRDETGSIRVTLWDNLTDIDVGRGDYVRVRGYIREGYYGGLECTANYVEILKKGEKIES
>T0503  Cyclic nucleotide binding regulatory protein, Cytophaga hutchinsonii, 191 residues	MHTALINHIRKFIFLTDEDAGTLSAFFQLKKVRKKETLLKTGEICRINYFVVKGCLRLFFIDEKGIEQTTQFAIENWWLSDYMAFQKQQPADFYIQSVENCELLSITYTEQENLFERIPALERYFRLVYQKSFAAAQLRSKFQHMYSKEEQYHNFSSRFPEFIQRVPQYLLASYLGFTPEYLSEIRKKYIS
>T0504 SETDB1, Homo sapiens, 208 residues	ENLYFQGDLIVSMRILGKKRTKTWHKGTLIAIQTVGPGKKYKVKFDNKGKSLLSGNHIAYDYHPPADKLYVGSRVVAKYKDGNQVWLYAGIVAETPNVKNKLRFLIFFDDGYASYVTQSELYPICRPLKKTWEDIEDISCRDFIEEYVTAYPNRPMVLLKSGQLIKTEWEGTWWKSRVEEVDGSLVRILFLDDKRCEWIYRGSTRLEP
>T0505 Stress response protein yhaX, Bacillus subtilis , 290 residues	SNAMSKQLLALNIDGALLRSNGKIHQATKDAIEYVKKKGIYVTLVTNRHFRSAQKIAKSLKLDAKLITHSGAYIAEKIDAPFFEKRISDDHTFNIVQVLESYQCNIRLLHEKYSIGNKKKVNSNLLGKALIHPSDPIFYPVQFVESLSDLLMDEPVSAPVIEVYTEHDIQHDITETITKAFPAVDVIRVNDEKLNIVPKGVSKEAGLALVASELGLSMDDVVAIGHQYDDLPMIELAGLGVAMGNAVPEIKRKADWVTRSNDEQGVAYMMKEYFRMQQRKGFLDKFHMKR
>T0506 Atu2129, Agrobacterium tumefaciens, 254 residues	MLDVAPPVITPRGTKIEPSAGAPFEAVRVARDVLHTSRTAALATLDPVSGYPYTTATNIGIEPDGTPFFFAAGLTLHARNMETDARISVTLAPFGKGDALTLPRLTLVGRADRIGPDEVPLAIARYIARYPKAKLYLSLPDTRLYRLRTEGVQINGGPARNASNITPADLRTDLSGAEELMAAAESEATRLNAIKGEASRLAVLAGAKTGRWKITSIDPDGIDLASASDLARLWFAERVETLKQFEKALAQLLK
>T0507 APC60073, Archaeoglobus fulgidus, 148 residues	MKVALGGTFEPLHEGHKKLIDVAIKLGGRDITIGVTSDRMARARIRSVLPFAIRAENVKRYVMRKYGFEPEIVKITNPYGKTLDVDFEYLVVSPETYEMALKINQKREELGKRKITIVKVDWMMAEDGKPISSTRIKRGEIDRYGGII
>T0508 Methyltransferase, Thermoplasma volcanium, 197 residues	MTGDRRDEYYWKAKKEQLRSRAAFKLEFLLDRYRVVRKGDAVIEIGSSPGGWTQVLNSLARKIISIDLQEMEEIAGVRFIRCDIFKETIFDDIDRALREEGIEKVDDVVSDAMAKVSGIPSRDHAVSYQIGQRVMEIAVRYLRNGGNVLLKQFQGDMTNDFIAIWRKNFSSYKISKPPASRGSSSEIYIMFFGFKAP
>T0509 Q8NRD3_CORGL , Corynebacterium glutamicum, 213 residues	MSNAFEYLRTYVESTTETDAAVARAREDAAEFGLPAPDEMTGQLLTTLAATTNGNGSTGAIAITPAAGLVGLYILNGLADNTTLTCIDPESEHQRQAKALFREAGYSPSRVRFLLSRPLDVMSRLANDSYQLVFGQVSPMDLKALVDAAWPLLRRGGALVLADALLDGTIADQTRKDRDTQAARDADEYIRSIEGAHVARLPLGAGLTVVTKA
>T0510 Fibrinogen binding protein, Staphylococcus aureus, 288 residues	MAYDGLFTKKMVESLQFLTTGRVHKINQPDNDTILMVVRQNRQNHQLLLSIHPNFSRLQLTTKKYDNPFNPPMFARVFRKHLEGGIIESIKQIGNDRRIEIDIKSKDEIGDTIYRTVILEIMGKHSNLILVDENRKIIEGFKHLTPNTNHYRTVMPGFNYEAPPTQHKINPYDITGAEVLKYIDFNAGNIAKQLLNQFEGFSPLITNEIVSRRQFMTSSTLPEAFDEVMAETKLPPTPIFHKNHETGKEDFYFIKLNQFNDDTVTYDSLNDLLDRFYDARGERERVKQ
>T0511 dehydrogenase, Xanthomonas campestris, 271 residues	MTLSGKTLFITGASRGIGLAIALRAARDGANVAIAAKSAVANPKLPGTIHSAAAAVNAAGGQGLALKCDIREEDQVRAAVAATVDTFGGIDILVNNASAIWLRGTLDTPMKRFDLMQQVNARGSFVCAQACLPHLLQAPNPHILTLAPPPSLNPAWWGAHTGYTLAKMGMSLVTLGLAAEFGPQGVAINALWPRTVIATDAINMLPGVDAAACRRPEIMADAAHAVLTREAAGFHGQFLIDDEVLAQAGITDLSGYAVDPQRALLPDLFLE
>T0512 surface layer protein BACUNI_02894, Bacteroides uniformis, 328 residues	ASGLFITNEGNFQYSNATLSYYDPATCEVENEVFYRANGFKLGDVAQSMVIRDGIGWIVVNNSHVIFAIDINTFKEVGRITGFTSPRYIHFLSDEKAYVTQIWDYRIFIINPKTYEITGYIECPDMDMESGSTEQMVQYGKYVYVNCWSYQNRILKIDTETDKVVDELTIGIQPTSLVMDKYNKMWTITDGGYEGSPYGYEAPSLYRIDAETFTVEKQFKFKLGDWPSEVQLNGTRDTLYWINNDIWRMPVEADRVPVRPFLEFRDTKYYGLTVNPNNGEVYVADAIDYQQQGIVYRYSPQGKLIDEFYVGIIPGAFCWKLEHHHHHH
>T0513 MutT/nudix family protein, Rhodospirillum rubrum, 292 residues	MSFLKHVQDCNTHDLSNFVRFVIEGRRVGWVRKALAQRLKAHGRVFDVTRDAVLLSASLRTPQSRTRAVADVVDRLADEGVVPAPRGELYRVNQSWGEPTLMLLDRAVVPTFGVRAYGVHLNGYVGAGADLHLWIGRRSPDKSVAPGKLDNMVAGGQPADLSLRQNLIKECAEEADLPEALARQAIPVGAITYCMESPAGIKPDTLFLYDLALPEDFRPHNTDGEMADFMLWPAAKVVEAVRTTEAFKFNVNLTVIDFAIRHGLIDPDNEPDYQEILAGLRGRPRERAASPA
>T0514 INVASION ASSOCIATED PROTEIN B, BARTONELLA HENSELAE, 145 residues	SSLTETYGLWSINCGIQEGKKVCFMHRQEVNDQNRVVVAMSVVLNADGVVSGNLTVPFGILVSKPVRLQVDEGKAVIETGIRTCVPAGCIVPIVFDKNYVAALRAGKHLKLAMTIAAPGEPPLNDLFVQLNGFSNALNRLIALQK
>T0515 putative carboxynorspermidine decarboxylase, Sinorhizobium meliloti, 365 residues	MIETPYYLIDKAKLTRNMERIAHVREKSGAKALLALKCFATWSVFDLMRDYMDGTTSSSLFEVRLGRERFGKETHAYSVAYGDNEIDEVVSHADKIIFNSISQLERFADKAAGIARGLRLNPQVSSSSFDLADPARPFSRLGEWDVPKVERVMDRINGFMIHNNCENKDFGLFDRMLGEIEERFGALIARVDWVSLGGGIHFTGDDYPVDAFSARLRAFSDRYGVQIYLEPGEASITKSTTLEVTVLDTLYNGKNLAIVDSSIEAHMLDLLIYRETAKVLPNEGSHSYMICGKSCLAGDVFGEFRFAEELKVGDRISFQDAAGYTMVKKNWFNGVKMPAIAIRELDGSVRTVREFTYADYEQSLS
>T0516 NP_765248.1, Staphylococcus epidermidis atcc 12228, 229 residues	MTFSKELREASRPIIDDIYNDGFIQDLLAGKLSNQAVRQYLRADASYLKEFTNIYAMLIPKMSSMEDVKFLVEQIEFMLEGEVEAHEVLADFINEPYEEIVKEKVWPPSGDHYIKHMYFNAFARENAAFTIAAMAPCPYVYAVIGKRAMEDPKLNKESVTSKWFQFYSTEMDELVDVFDQLMDRLTKHCSETEKKEIKENFLQSTIHERHFFNMAYINEKWEYGGNNNE
>T0517 YP_755085.1, Syntrophomonas wolfei str. Goettingen, 159 residues	MENKKMNLLLFSGDYDKALASLIIANAAREMEIEVTIFCAFWGLLLLRDPEKASQEDKSLYEQAFSSLTPREAEELPLSKMNLGGIGKKMLLEMMKEEKAPKLSDLLSGARKKEVKFYACQLSVEIMGFKKEELFPEVQIMDVKEYLKNALESDLQLFI
>T0518 ZP_02066194.1, Bacteroides ovatus, 288 residues	MKKVFYPLACCCLAAGVFASCGGQKKANAQEEPSKVALSYSKSLKAPETDSLNLPVDENGYITIFDGETFNGWRGYGKDRVPTKWTIEDGCIKFNGSGGGEAQDGDGGDLIFAHKFKNFELELEWKVAKGSNSGILYLAQEVTSKDKDGNDVLEPIYISAPEYQILDNANHPDAKLGKDNNRQSASLYDMIPAVPQNSKPFGEWNKAKIMVYKGTVVHGQNDENVLEYHLWTKQWTDMLQASKFSEDKWPLAFELLNNCGGENHEGFIGLQDHGDDVWFRNIRVKVLD
>T0519 PF11_0239, unknown, 180 residues	GISPNVLNNMKSYMKHSNIRNIIINIMAHELSVINNHIKYINELFYKLDTNHNGSLSHREIYTVLASVGIKKWDINRILQALDINDRGNITYTEFMAGCYRWKNIESTFLKAAFNKIDKDEDGYISKSDIVSLVHDKVLDNNDIDNFFLSVHSIKKGIPREHIINKISFQEFKDYMLSTF
>T0520 3MR7, Silicibacter pomeroyi, 189 residues	SNAERRLCAILAADMAGYSRLMERNETDVLNRQKLYRRELIDPAIAQAGGQIVKTTGDGMLARFDTAQAALRCALEIQQAMQQREEDTPRKERIQYRIGINIGDIVLEDGDIFGDAVNVAARLEAISEPGAICVSDIVHQITQDRVSEPFTDLGLQKVKNITRPIRVWQWVPDADRDQSHDPQPSHVQH
>T0521 pf110239_CAD, Plasmodium Falciparum, 179 residues	ISPNVLNNMKSYMKHSNIRNIIINIMAHELSVINNHIKYINELFYKLDTNHNGSLSHREIYTVLASVGIKKWDINRILQALDINDRGNITYTEFMAGCYRWKNIESTFLKAAFNKIDKDEDGYISKSDIVSLVHDKVLDNNDIDNFFLSVHSIKKGIPREHIINKISFQEFKDYMLSTF
>T0522 NP_384335.1, SINORHIZOBIUM MELILOTI 1021, 134 residues	MTTFTLDERLERDGIPIGTLGLCQMRLMNDRRWPWLILVPQRADIKEVFELTPLDQAMLTFETNLVAAGLKKATGAEKINIGALGNIVRQLHVHVIARREGDPNWPGPVWGFGKAEPWPEEEHRTFAARIMENL
>T0523 3MQO, Burkholderia thailandensis, 120 residues	PAIDYKTAFHLAPIGLVLSRDRVIEDCNDELAAIFRCARADLIGRSFEVLYPSSDEFERIGERISPVMIAHGSYADDRIMKRAGGELFWCHVTGRALDRTAPLAAGVWTFEDLSATRRVA
>T0524 NP_389718.1, Bacillus subtilis, 325 residues	MANFIEKITYLGTPAIKAGNEHLEMIVVPEWGSNVISLVDKTTNVQLLREPETAESFHDTPTLYGIPILFPPNRISDGTFSFRGRTYHFDINEKDKHNHLHGFLYHEKWNVVTTKQTDEGVIVETEIDLSELPHVQKQFPHHAVVRMTYTIKENTLFKHATVMNKGKEAFPWGIGYHTTFIFPAESSLFSLTADQQWELDERLLPTGKLMDVPYKEALHEGMDLRHKQLDDVFLSSYQKRGGENQAVIYHQHAHISIIYKADEQFKHWVVYNADGKQGYLCPEPYTWVTNAVNLDLPSSLTGLQVLEPGEETTAKSSITIELNHQ
>T0525 APC41548.0, unknown, 215 residues	SNAMSVQTIERLQDYLLPEWVSIFDIADFSGRMLRIRGDIRPALLRLASRLAELLNESPGPRPWYPHVASHMRRRVNPPPETWLALGPEKRGYKSYAHSGVFIGGRGLSVRFILKDEAIEERKNLGRWMSRSGPAFEQWKKKVGDLRDFGPVHDDPMADPPKVEWDPRVFGERLGSLKSASLDIGFRVTFDTSLAGIVKTIRTFDLLYAEAEKGS
>T0526 NP_417039.1, Escherichia coli k12, 290 residues	MTIYTLSHGSLKLDVSDQGGVIEGFWRDTTPLLRPGKKSGVATDASCFPLVPFANRVSGNRFVWQGREYQLQPNVEWDAHYLHGDGWLGEWQCVSHSDDSLCLVYEHRSGVYHYRVSQAFHLTADTLTVTLSVTNQGAETLPFGTGWHPYFPLSPQTRIQAQASGYWLEREQWLAGEFCEQLPQELDFNQPAPLPRQWVNNGFAGWNGQARIEQPQEGYAIIMETTPPAPCYFIFVSDPAFDKGYAFDFFCLEPMSHAPDDHHRPEGGDLIALAPGESTTSEMSLRVEWL
>T0527 APC67421.1, Burkholderia thailandensis E264, 142 residues	SNALSASEERFQLAVSGASAGLWDWNPKTGAMYLSPHFKKIMGYEDHELPDEITGHRESIHPDDRARVLAALKAHLEHRDTYDVEYRVRTRSGDFRWIQSRGQALWNSAGEPYRMVGWIMDVTDRKRDEDALRVSREELRRL
>T0528 NP_949733.1, Rhodopseudomonas palustris CGA009, 388 residues	MTATAVALATTAVHAADDLKIALIYGKTGPLEAYAKQTETGLMMGLEYATKGTMTLDGRKIVVITKDDQSKPDLSKAALAEAYQDDGADIAIGTSSSAAALADLPVAEENKKILIVEPAVADQITGEKWNRYIFRTGRNSSQDAISNAVAIGKQGVTIATLAQDYAFGRDGVAAFKEALAKTGATLATEEYVPTTTTDFTAVGQRLFDALKDKPGKKIIWVIWAGGGDPLTKLQDMDPKRYGIELSTGGNILPALAAYKRLPGMEGATYYYYDIPKNPINEWLVTEHQKRFNAPPDFFTAGGFSAAMAVVTAVQKAKSTDTEKLIAAMEGMEFDTPKGKMVFRKEDHQALQSMYHFKVKVDPAVAWAVLEPVRELKIEEMNIPIKNKK
>T0529 Nucleoprotein structure of lassa fever virus, unknown, 569 residues	MSASKEIKSFLWTQSLRRELSGYCSNIKLQVVKDAQALLHGLDFSEVSNVQRLMRKERRDDNDLKRLRDLNQAVNNLVELKSTQQKSILRVGTLTSDDLLILAADLEKLKSKVIRTERPLSAGVYMGNLSSQQLDQRRALLNMIGMSGGNQGARAGRDGVVRVWDVKNAELLNNQFGTMPSLTLACLTKQGQVDLNDAVQALTDLGLIYTAKYPNTSDLDRLTQSHPILNMIDTKKSSLNISGYNFSLGAAVKAGACMLDGGNMLETIKVSPQTMDGILKSILKVKKALGMFISDTPGERNPYENILYKICLSGDGWPYIASRTSITGRAWENTVVDLESDGKPQKADSNNSSKSLQSAGFTAGLTYSQLMTLKDAMLQLDPNAKTWMDIEGRPEDPVEIALYQPSSGCYIHFFREPTDLKQFKQDAKYSHGIDVTDLFATQPGLTSAVIDALPRNMVITCQGSDDIRKLLESQGRKDIKLIDIALSKTDSRKYENAVWDQYKDLCHMHTGVVVEKKKRGGKEEITPHCALMDCIMFDAAVSGGLNTSVLRAVLPRDMVFRTSTPRVVL
>T0530 NP_391841.1, Bacillus subtilis, 115 residues	MKKAMAILAVLAAAAVICGLLFFHNDVTDRFNPFIHQQDVYVQIDRDGRHLSPGGTEYTLDGYNASGKKEEVTFFAGKELRKNAYLKVKAKGKYVETWEEVKFEDMPDSVQSKLK
>T0531 JTB, Homo Sapiens, 65 residues	GSGMKEFPCWLVEEFVVAEECSPCSNFRAKTTPECGPTGYVEKITCSSSKRNEFKSCRSALMEQR
>T0532 YP_210662.1, Bacteroides fragilis nctc 9343, 506 residues	MKRINKYISLLLATALLASCDKFDEINTDPDATTKVTSSLLATGLLLDITSSSASKSFIYDELLAKQMAWGESMEDYQYNVFGRSGFGGYTTLINAQKMVESVSDDNVNAYDGLAHFIKAYKIFYMSMEMGDLPYEEALQGELGLVRPKYNTQKEVMNFILSDLETAYELFSTAKDFDGDPILGGSISKWKKATTAFQLKVLMHLSKKESDADLKVKERFARIVASGSLMESNEDNLQMKYADKANTVYPFHNTNTKHAGYAMLSTMLIDKFKATGDIRMFYYAKPAKAKLNEGVTADSWDAYIGTDPSLPFEQIEKAYATEQYSGFNARYTDYPSGEPVVRLGYAEQNFILAEAAVRGWISGDASAYYKKAIRAHMEFIASNTPDEEVYHHGHPITEEAIAAFLETPAIQLSGEKEADIEKILTQRYLASFMQHPYDVYYDYRRTGYPVLPINPATNRNTMNDRLPMRWMYPKSESDYNLEHQNEALERQFGGVDDVNKLMWILQ
>T0533 3MWB, unknown, 313 residues	SNAMSAVTYTFLGPQGTFTEAALMQVPGAADATRIPCTNVNTALERVRAGEADAAMVPIENSVEGGVTATLDAIATGQELRIIREALVPITFVLVARPGVELSDIKRISTHGHAWAQCRLWVDEHLPNADYVPGSSTAASAMGLLEDDAPYEAAICAPLIAAEQPGLNVLAEDIGDNPDAVTRFILVSRPGALPERTGADKTTVVVPLPEDHPGALMEILDQFASRGVNLSRIESRPTGQYLGHYFFSIDADGHATDSRVADALAGLHRISPATRFLGSYARADKQPAVVAPHTSDAAFASAHAWVDSILKGS
>T0534 ZP_02066800.1, Bacteroides ovatus, 384 residues	MMKTKFFYVAALILGLAFTTTSCSSDDDNPTVDPANIDYTPENASSWHNYMRNVAALLKTDATNLYNAWNSSYKGGESYASLFKAHSGSPYASALSCVEEIVDKCAEIANEVGTAKIGDPYNLYKAGNTEEALYAVESWYSWHSRDDYTNNIYSIRNAYYGSLDGNINANSLSTVIAGANSSLDTKIKNAIQKAAKAIQDIPQPFRNHIPSNETVAAMDACAELESILKNDLKSYIANNSNNINTDAVLNPVVTQYVDAVVVPTYKSLKEKNDALYNAVIVLADNPSNSAFETACDAWITAREPWEKSEAFLFGPVDEMGLDPNMDSWPLDQNAIVQILNSQSWSDLEWSEGDDEAAVESAQNVRGFHTLEFLLYKNGEPRKVQ
>T0535 FGD5, Homo sapiens, 294 residues	QSRALVIAQELLSSEKAYVELQHLNLDFHGAVRALDDDHEDTLAREELRQGLSELPAIHDLHQGILEELEERLSNWESQQKVADVFLAREQGFDHHAHILQFDRYLGLLSENCLHSPRLAAAVREFEQSTAKHRLLRVVQRLFQYQVLLTDYLNNLCPDSAEYDNTQGALSLISKVTDRANDSEQGENLQKLVHIEHSVRGQGDLLQPGREFLKEGTLKVTGKNRRPRHLFLNDVLLYTYPQKDGKYRLKNTLAVSRPVEKVPYALKIETSESCLLSASSCAERDEWYGCLSRA
>T0536 sensory box sensor histidine kinase, Vibrio cholerae, 152 residues	MHHHHHHENLYFQSNAMAKSRLLLSELLDQLSFALCIVRNDYVIVKVNEYFESRVIFDGETMQGKNILELFPESADYLKRKIDTALVIESSSFSSWEQKPHLLPFKSSRPVSGEEEQMYQNLEVIPIHSEDGTIEHVCLCVYDVTIQASQQQ
>T0537 ZP_02066290.1, Bacteroides ovatus, 381 residues	MNITQIGRFGMLLMMASVAISCSDPNPLDSYTRVPFEKTETDDGNGDGDGDGAGGLFEKGNGTDSKPYMIMNATQIRNMRSVLKSGMKVYFQLGADIDMAGIDDWQSLNGSGDFPYEIDFDGDSHVIKNFKCSAGDYPSFFGVLCGDCRNVGFVNASVSSARQGIGIITGYLGLKDKGNGNKTGRIVNCYTTGEVIGSGAAGGIAGVLANSYDGQESYIKNCYSNATVSDRAASGGKAGGIAGRKVGVGGFIENCYAYGAVSATKGGVGGILGQIDKSCDIAIKNSAAWSNLTGVDASSTVGRIVGVSASLGSYENCYACESIVLKVNEKTITASDESSATGTTFHGVAKSAEELGNIIVAWNPNLWKKGTNGYPIFQWSE
>T0538 NsR143, , 54 residues	MNLRWTSEAKTKLKNIPFFARSQAKARIEQLARQAEQDIVTPELVEQARLEFGQ
>T0539 HR4710B, , 81 residues	MVANPPASKESIDALPEILVTEDHGAVGQEMCCPICCSEYVKGEVATELPCHHYFHKPCVSIWLQKSGTCPVCRCMFPPPL
>T0540 FAIM-NTD, Human, 90 residues	MTDLVAVWDVALSDGVHKIEFEHGTTSGKRVVYVDGKEEIRKEWMFKLVGKETFYVGAAKTKATINIDAISGFAYEYTLEINGKSLKKYM
>T0541 MvR254A, , 106 residues	MIPDLVPVSLTPVTVVPNTVNTMTATIENQGNKDSTSFNVSLLVDGIVVDTQTVTSLESENSTNVDFHWTLDGTANSYTLTVNVDPENAVNEGNESNNTLTALVGT
>T0542 NH3-DEPENDENT NAD+ SYNTHETASE, STREPTOMYCES AVERMITILIS, 590 residues	MSLQLRLALNQIDSTVGDIAGNAEAILRWTRHSAEQGAHLVAFPEMALTGYPVEDLALRSSFVEASRTALRELAARLAEEGFGELPVLVGYLDRSESAQPKYGQPAGAPRNAAAVLHRGRVALTFAKHHLPNYGVFDEFRYFVPGDTMPIVRLHGVDIALAICEDLWQDGGRVPAARSAGAGLLLSVNASPYERDKDDTRLELVRKRAQEAGCTTAYLAMIGGQDELVFDGDSIVVDRDGEVVARAPQFSEGCVVLDLDLPAAEAEPPTGVVDDGLRIDRLVISEEPLPAYEAELAGGYADRLDADEEVYSALVVGLRAYVAKNGFRSVLIGLSGGIDSALVAAIACDALGAQNVYGVSMPSKYSSDHSKGDAAELARRTGLNFRTVSIEPMFDAYMASLGLTGLAEENLQSRLRGTTLMAISNQEGHIVLAPGNKSELAVGYSTLYGDSVGAYGPIKDVYKTSIFRLAEWRNRAAAERGQTPPIPEASITKPPSAELRPGQVDTDSLPDYPVLDAILELYVDRDTGADAIVAAGYDRELVVKTLRMVDTAEYKRRQYPPGTKISAKGFGKDRRLPITNRWREGHHHHHH
>T0543 Autotaxin, RAT, 887 residues	MARQGCLGSFQVISLFTFAISVNICLGFTASRIKRAEWDEGPPTVLSDSPWTNTSGSCKGRCFELQEVGPPDCRCDNLCKSYSSCCHDFDELCLKTARGWECTKDRCGEVRNEENACHCSEDCLSRGDCCTNYQVVCKGESHWVDDDCEEIKVPECPAGFVRPPLIIFSVDGFRASYMKKGSKVMPNIEKLRSCGTHAPYMRPVYPTKTFPNLYTLATGLYPESHGIVGNSMYDPVFDASFHLRGREKFNHRWWGGQPLWITATKQGVRAGTFFWSVSIPHERRILTILQWLSLPDNERPSVYAFYSEQPDFSGHKYGPFGPEMTNPLREIDKTVGQLMDGLKQLRLHRCVNVIFVGDHGMEDVTCDRTEFLSNYLTNVDDITLVPGTLGRIRAKSINNSKYDPKTIIANLTCKKPDQHFKPYMKQHLPKRLHYANNRRIEDIHLLVDRRWHVARKPLDVYKKPSGKCFFQGDHGFDNKVNSMQTVFVGYGPTFKYRTKVPPFENIELYNVMCDLLGLKPAPNNGTHGSLNHLLRTNTFRPTMPDEVSRPNYPGIMYLQSEFDLGCTCDDKVEPKNKLEELNKRLHTKGSTEAETGKFRGSKHENKKNLNGSVEPRKERHLLYGRPAVLYRTSYDILYHTDFESGYSEIFLMPLWTSYTISKQAEVSSIPEHLTNCVRPDVRVSPGFSQNCLAYKNDKQMSYGFLFPPYLSSSPEAKYDAFLVTNMVPMYPAFKRVWAYFQRVLVKKYASERNGVNVISGPIFDYNYDGLRDTEDEIKQYVEGSSIPVPTHYYSIITSCLDFTQPADKCDGPLSVSSFILPHRPDNDESCNSSEDESKWVEELMKMHTARVRDIEHLTGLDFYRKTSRSYSEILTLKTYLHTYESEI
>T0544 SnR168A, , 135 residues	MPLEWRAGASSDEINAIIRAVYRQVLGNDYVMSTERLTSAESLLRGGEISVRDFVRAVALSELYREKFFHNNAHNRFIELNFKHLLGRAPYDQAEVAAHAATYHSHGYDADINSYIDSAEYTESFGDNVVPYFRG
>T0545 MvR76 , , 158 residues	MIKRGFPAVLDENTEILILGSLPSDESIRKQQYYGNPGNDFWRLVGHAIGENLQDMAYEKKLKTLKHNRIGLWDVFKAGSREGSQDSKIGDEEINDFSGLKEMVPKLRLICFNGRKAGEYEPLLRGMGYETKVLPSSSGANRRFSKNRESEWEAVFRH
>T0546 BvR159, , 134 residues	MLKTILSIAGKPGLYKLISQGKNMLIVETVDAAKKRVPAYAHDKVISLADIAMYTDAEEVPLSEVLEAVKKKENGAVASINYKKASADELHAYFAEVLPNYDRDRVHNGDIKKLISWYNILVNNGITEFVEAPA
>T0547 BR53, unknown, 611 residues	MMDYGIDIWGNENFIIKNGKVCINYEKKPAIIDIVKELRDDGYKGPLLLRFPHLIQKQIENIYGNFNKARKEFGYKGGFNAVYPLKVNQYPGFVKNLVKLGKDYNYGLEAGSKAELLLAMAYNNEGAPITVNGFKDRELINIGFIAAEMGHNITLTIEGLNELEAIIDIAKERFKPKPNIGLRVRLHSAGVGIWAKSGGINSKFGLTSTELIEAVNLLKENKLLEQFTMIHFHLGSQITEIHPLKKALNEAGNIYTELRKMGAKNLKAINLGGGLAVEYSQFKNEKSRNYTLREYANDVVFILKNIAEQKKDLEPDIFIESGRFVAANHAVLIAPVLELFSQEYAENKLILKKQNPKLIDELYDLYKSIKPSNALEYLHDSIDHLESILTLFDLGYVDLQDRSNAEILTHLITKKAILLLGDKQNPADLLAIQDEVQERYLVNFSLFQSMPDFWGLEQNFPIMPLDRLDEEPTRSASIWDITCDSDGEISYSKDKPLFLHDVDVEKENYFLGFFLVGAYQEVLGMKHNLFTHPTEAIISINEKGYEVEGIIEAQSILDTLEDLDYDIHAIMDILNERISNSKLVNDKQKKHILGELYLFLNDNGYLKSIGV
>T0548 OR3 , , 106 residues	MIENSSPYTSEHFHYTVTDIKDLTKLGAIYDKTKKYWVYQGKPVMPDQFTFELLDFLHQLTHLSFSKMKALLERSHSPYYMLNRDRTLKNITETCKACAQVNASKS
>T0549 CvR118A, , 84 residues	MPHKEKHPLQDMFTSAIEAVARDSGWAELSAVGSYLAKNDPSFDPRNWGHGRLSQMVKKLDFLTVQESRNGSKLHSEIRLRHDG
>T0550 ZP_02066326.1, Bacteroides ovatus, 339 residues	MKNIYIYLSLLAVIVLGTACNNEWEDEQYEQYVSFKAPIASGSDGVTTIYVRYKDNGKVTYQLPIIVSGSTVNSQDRDIHIAVDKDTLKTLNIERFSLYRPELWYTEMEEDKYEFPETVHIPAGSCVELLNIDFNLQDIDMLEKWVLPLTIVDDGSYAYQSHPRKNYAKALLKVVPFNNYSGSYTASSMKVYTYINGKPDTNARTTDKRTGYVVDNNSIFFYAGLINEDMDKDMRKKYKINVHFKEDGTLDMKQDDPSNEMEFELIGTPTYSSTSVMDATRPYLERRYVQIMFEYDFQDFTYGGSGTEVIPIKYRVAGSMTLLRNINTQIPDEDQQIEW
>T0551 SpR104 , , 74 residues	MKKMAEFTFEIEEHLLTLSENEKGWTKEINRVSFNGAPAKFDIRAWSPDHTKMGKGITLSNEEFQTMVDAFKGN
>T0552 BtR376, , 122 residues	MNDDVDIQQSYPFSIETMPVPKKLKVGETAEIRCQLHRDGRFEETKYFIRYFQPDGAGTLKMSDGTVLLPNDLYPLPGETFRLYYTSASTDQQTVDVYFQDSFGQLQQLTFSFNNDSSKEEE
>T0553 NsR123E , , 141 residues	MKVFKRVAGIKDKAAIKTLISAAYRQIFERDIAPYIAQNEFSGWESKLGNGEITVKEFIEGLGYSNLYLKEFYTPYPNTKVIELGTKHFLGRAPIDQAEIRKYNQILATQGIRAFINALVNSQEYNEVFGEDTVPYRRFPT
>T0554 TeR219A , , 135 residues	MPVELRANWSEEDLETVIRAVYRQVLGNDYVMASERLVSAESLLRNGKITVREFVRAVAKSELYKEKFLYGNFQTRVIELNYKHLLGRAPYDESEVIFHLDLYENEGFDADIDSYIDSPEYTNSFGDWVVPYYRG
>T0555 SgR209C, , 148 residues	MPQSYFNAAAKRQKYAMKPGLSALEKNAVIKAAYRQIFERDITKAYSQSISYLESQVRNGDISMKEFVRRLAKSPLYRKQFFEPFINSRALELAFRHILGRGPSSREEVQKYFSIVSSGGLPALVDALVDSQEYADYFGEETVPYLRG
>T0556 HR4435B, , 73 residues	MLPPEQWSHTTVRNALKDLLKDMNQSSLAKECPLSQSMISSIVNSTYYANVSAAKCQEFGRWYKHFKKTKDMM
>T0557 NeR70A, , 145 residues	MRSATDLLDELNAVDESARIEAKRASDMGKSVMETVIAFANEPGLDGGYLLLGVDWAINDKGDTVYRPVGLPDPDKVQRDLASQCASMLNVALRPEMQLEQVGGKTLLVVYVPEADVTHKPIYKKATGLPGGAYRRIGSSDQRCV
>T0558 ZP_01960044.1, Bacteroides caccae, 294 residues	MKNFILLVALFLVAPFAQGSSPQHLLVGGSGWNKIAIINKDTKEIVWEYPLEKGWECNSVAATKAGEILFSYSKGAKMITRDGRELWNIAAPAGCEMQTARILPDGNALVAWCGHPSTILEVNMKGEVLSKTEFETGIERPHAQFRQINKNKKGNYLVPLFATSEVREIAPNGQLLNSVKLSGTPFSSAFLDNGDCLVACGDAHCFVQLNLESNRIVRRVNANDIEGVQLFFVAQLFPLQNGGLYICNWQGHDREAGKGKHPQLVEIDSEGKVVWQLNDKVKFGMISTICPIRE
>T0559 BvR153, , 69 residues	MKMLKEKAGALAGQIWEALNGTEGLTQKQIKKATKLKADKDFFLGLGWLLREDKVVTSEVEGEIFVKLV
>T0560 BtR375, , 74 residues	MDKKIVGANAGKVWHALNEADGISIPELARKVNLSVESTALAVGWLARENKVVIERKNGLIEIYNEGHFDFSFG
>T0561 JBP1 , Leishmania Tarentolae, 161 residues	VEKKKYLDSEFLLHCISAQLLDMWKQARARWLELVGKEWAHMLALNPERKDFLWKNQSEMNSAFFDLCEVGKQVMLGLLGKEVALPKEEQAFWIMYAVHLSAACAEELHMEVAMSLRKLNVKLKDFNFGGTRYFKDMPPEEKKRRMERKQRIEEARRHGMP
>T0562 CmR116, , 123 residues	MKDGTYYAEADDFDESGWKDTVTIEVKNGKIVSVDWNAINKDGGDDKDTLSRNGGYKMVEYGGAQAEWHEQAEKVEAYLVEKQDPTDIKYKDNDGHTDAISGATIKVKKFFDLAQKALKDAEK
>T0563 NP_718175.1, Shewanella oneidensis MR-1, 279 residues	MKLETIDYRAADSAKRFVESLRETGFGVLSNHPIDKELVERIYTEWQAFFNSEAKNEFMFNRETHDGFFPASISETAKGHTVKDIKEYYHVYPWGRIPDSLRANILAYYEKANTLASELLEWIETYSPDEIKAKFSIPLPEMIANSHKTLLRILHYPPMTGDEEMGAIRAAAHEDINLITVLPTANEPGLQVKAKDGSWLDVPSDFGNIIINIGDMLQEASDGYFPSTSHRVINPEGTDKTKSRISLPLFLHPHPSVVLSERYTADSYLMERLRELGVL
>T0564 SlR115, , 89 residues	MAPLQQKQVVVSNKREKPVNDRRSRQQEVSPAGTSMRYEASFKPLNGGLEKTFRLQAQQYHALTVGDQGTLSYKGTRFVGFVSRTPDNE
>T0565 ZP_02063661.1, Bacteroides ovatus, 326 residues	MKKNILLFYCFLATMAASLKAQEIRPMPADSAYGVVHISVCNLREEGKFTSGMSTQALLGMPVKVLQYNGWYEIQTPDDYTGWVHRMVITPMSKERYDEWNRAEKIVVTSHYGFAYEKPDESSQPVSDVVAGNRLKWEGSKGHFYQVSYPDGRKAYLSKSISQPEAGWRASLKQDVESIIETAYSMMGIPYLWAGTSSKGVDCSGLVRTVLFMHDIIIPRDASQQAYVGEHIDIAPDFSNVKRGDLVFFGRKATAERKEGISHVGIYLGNKQFIHALGDVHVSSMNPADQNYDEFNTKRLLFAVRFLPYINKEKGMNTTNKNPFYQ
>T0566 pfc0270w, Plasmodium Falciparum, 156 residues	SGRENLYFQGERNYNKWAESYIKYNLSNLKIEKEDLTIYFDNLQVSGNACVSIRKGKQINSFEYIIKFEWLYSKKKEGKDYFGGSVEIPDFSTFSLEENDYAINIERTDESENLRFIYDSILKKEGKEKIKECLKNFQEDLLKHDKNESNKELKIK
>T0567 NTPase domain of the Sigma-54 transport activator, E. coli, 145 residues	VELIGRSEWINQYRRRLQQLSETDIAVWLYGAPGTGRMTGARYLHQFGRNAQGEFVYRELTPDNAPQLNDFIALAQGGTLVLSHPEHLTREQQYHLVQLQSQEHRPFRLIGIGDTSLVELAASNHIIAELYYCFAMTQIACLPLT
>T0568 NP_250297.1, Pseudomonas aeruginosa PA01, 158 residues	MSFIRSCISRSVFLLGAGVAVAAQAEVRIDGPIEYGVFESRYQDFQPGERVLTRSEQNIQQTTEVPAKLGTKFGMRYQLSGKQEGDTPLTLLYLTPGVVTPDGQRHDKFEVVQKLVPGAPTDVMAYEFTEPHEVVKGEWRLMVFQGDRLLAEKSFDVR
>T0569 PtR41O, , 79 residues	MDEDATITYVDDDKGGAQVGDIVTVTGKTDDSTTYTVTIPDGYEYVGTDGGVVSSDGKTVTITFAADDSDNVVIHLKHG
>T0570 YP_001301802.1, Parabacteroides distasonis atcc 8503, 258 residues	MNLKSTLLLLLCLMMAGMVAAKDNTKVIAHRGYWKTEGSAQNSIRSLERASEIGAYGSEFDVHLTADNVLVVYHDNDIQGKHIQSCTYDELKDLQLSNGEKLPTLEQYLKRAKKLKNIRLIFELKSHDTPERNRDAARLSVQMVKRMKLAKRTDYISFNMDACKEFIRLCPKSEVSYLNGELSPMELKELGFTGLDYHYKVLQSHPDWVKDCKVLGMTSNVWTVDDPKLMEEMIDMGVDFITTDLPEETQKILHSRAQ
>T0571 ZP_02066433.1, Bacteroides ovatus ATCC 8483, 344 residues	MKKNLAYIGLVLLILTWTSCESSDNEFPDFDYQTVYFANQYGLRTIELGESEFVDNTLDNQHKMVIKAAWGGGYTNRNNVVINFKVDESLCDNLYFKDTDQPLVPMPASYYTLASDRIAIPKGQIMAGVEVQLTDDFFADEKSISENYVIPLLMTNVQGADSILQGKPVVENPVLTNAGDWSILPQNFVLYAVKYVNPWHGEYLRRGIDHATVAGTSKDIIRHEQFVENDEVVNISTKSMKDNLLTLKTKDESGKDISYTVRLSFAEDGSCTVHSGSQNVVVSGSGKFVSKGEKNSLGGKDRNAIYLDYTVNLTDNNIQLATKDTLVLRTRNVYGGKSLEVVRK
>T0572 SuR18C, , 93 residues	MKISLRKLSKSVPVKLELTGDKASNVSSISYSFDRGHVTIVGSQEAMDKIDSITVPVDISQVTEDTSKTLELKAEGVTVQPSTVKVNLKVTQK
>T0573 NP_419019.1, CAULOBACTER CRESCENTUS, 311 residues	MSTSAIDPVSFSLYAKDFTRFAQELGASFERYGFAVLSDYDLDQARIDAAVDSAKAFFALPVETKKQYAGVKGGARGYIPFGVETAKGADHYDLKEFWHMGRDLPPGHRFRAHMADNVWPAEIPAFKHDVSWLYNSLDGMGGKVLEAIATYLKLERDFFKPTVQDGNSVLRLLHYPPIPKDATGVRAGAHGDINTITLLLGAEEGGLEVLDRDGQWLPINPPPGCLVINIGDMLERLTNNVLPSTVHRVVNPPPERRGVPRYSTPFFLHFASDYEIKTLQNCVTAENPDRYPESITADEFLQQRLREIKLA
>T0574 NP_250624.1, Pseudomonas aeruginosa PA01, 126 residues	MKNAMALTLAGLLAAPSLGFAAAPDAVMVFARQGDKGSVSVGDKHFRTQAFKVRLVNAAKSEISLKNSCLVAQSAAGQSFRLDTVDEELTADTLKPGASVEGDAIFASEDDAVYGASLVRLSDRCK
>T0575 YP_001636308.1, CHLOROFLEXUS AURANTIACUS, 216 residues	MPTETFFNLPEEKRSRLIDVLLDEFAQNDYDSVSINRITERAGIAKGSFYQYFADKKDCYLYLIQLGIEQKTAFLRQTPPASTTDMFAYLRWLLDVGIQFQFHNPRLAQIAYKALYDDVPLPAETMQVIRHGSFAYFKQLVEQGIADGSLVPDLDADTAAFVLNVVFTELGNHLIERFAVNPAELLREGGIVLLQPAMRRVIEQVIDILERGMRRR
>T0576 3NA2, Leptospirillum rubarum, 172 residues	MGSSHHHHHHSSGRENLYFQGHVEPGVTDRIGQMILEMFRTGMCLFSVRSPGGVAELYGGEARKVEITGTSLTIEREDWHLHCKLETVETVVFDLSPKDNGGIRMAVVFRDKHQAPVLRAAWLPRLMPETPSPPEQFWAFTQRYIDLPMVVDARNRQLVFPGSGQGGFTEGS
>T0577 BvR155, , 116 residues	MNELDIQQEYPFTVESMPVADEIAGDETVEIRLEIKPSGNFIGTVYTLRYFQPDGKGSLKMEDGTVLKPNDRYLLNEWKFRLYYTSQSDKEAQTIDLYFEDNWGNLQQLTYDFNGK
>T0578 3NAT, Enterococcus faecalis, 164 residues	SNAMKKATMLTYLEEQLEKHLGDYEVGLDWDRKNHTIEVIVRLYAENNEQVAIDDVDGTLSEEEFIEFEDGLLFYNPQKSVVDDEEYLVTIPYEGKKGLRKAVLDGFIHYLKVVLDEGQSDLLDFLSDETAEVFELHWEPADFEAMIKKVAETEKEQWIAYPSY
>T0579 SR518, , 124 residues	MKVGSQVIINTSHMKGMKGAEATVTGAYDTTAYVVSYTPTNGGQRVDHHKWVIQEEIKDAGDKTLQPGDQVILEASHMKGMKGATAEIDSAEKTTVYMVDYTSTTSGEKVKNHKWVTEDELSAK
>T0580  lactose-specific IIB PTS system component, Streptococcus pneumoniae TIGR4, 105 residues	SKELKVLVLCAGSGTSAQLANAINEGANLTEVRVIANSGAYGAHYDIMGVYDLIILAPQVRSYYREMKVDAERLGIQIVATRGMEYIHLTKSPSKALQFVLEHYQ
>T0581 NP_252301.1, Pseudomonas aeruginosa PA01, 136 residues	MSRFMALALCFVLPTAAHAASLKDFELSKMLEKVAKESSVGTPRAINEDILDQGYTVEGNQLINHLSVRASHAERMRSNPDSVRSQLGDSVCSNTGYRQLLARGAILTYSFTEYKTNQPVATERFDAGSCRIQGKK
>T0582 YP_957874.1, Marinobacter aquaeolei VT8, 222 residues	MEINADFTKPVVIDTDQLEWRPSPMKGVERRMLDRIGGEVARATSIVRYAPGSRFSAHTHDGGEEFIVLDGVFQDEHGDYPAGTYVRNPPTTSHVPGSAEGCTIFVKLWQFDPADRTQFSKNMEAELGAPVEGISTSLLHEDERETVTHRKLEPGANLTSEAAGGIEVLVLDGDVTVNDEVLGRNAWLRLPEGEALSATAGARGAKIWMKTGHLRFVRTPEV
>T0583 LR17, , 152 residues	MPQFTTARRARHRAEQMFALVADVEKYPQFLPMCEALSIRSRKERDGKTLLIADMTVGYKLIRETFTSQVLLKPDENIIDVKYIDGPFRYLDNRWTFRPTDGGAQCDVEFFIDYEFKSRTLGLLMGTMFDLAFKKFSEAFEKRADQIYGLGE
>T0584 3NF2, Streptomyces coelicolor, 352 residues	MSLDVTALLERGRTLATPVLRAAVDRLAPPMDTVAAYHFGWIDAQGNPADGDGGKAVRPALAVLSAEVTGAAPEVGVPGAVAVELVHNFSLLHDDLMDGDEQRRHRDTVWKVHGPAQAILVGDALFALANEVLLELGTVEAGRATRRLTKASRSLIDGQAQDISYEHRDRVSVEECLEMEGNKTGALLACASSIGAVLGGADERTADTLEKYGYHLGLAFQAVDDLLGIWGDPDATGKQTWSDLRQRKKSLPVVAALAAGGAASERLGEILTADAKASDFANFSEEEFAARAALIEEAGGREWTADEARRQHTIAIEALDAVDMPDRVRDRFTALADFVVVRKREGHHHHHH
>T0585 APC62366.1, Bartonella henselae, 234 residues	SNASFRVVLDPGHGGIDGGARGVTGILEKDVTLAFARALRDELQKGSHTIVALTRDSDIFLRLSERVKKAQEFDADLFISIHADTIDVHSLRGATVYTISDEASDAIAKSLAESENKVDLLDGLPKEESLELTDILLDLTRRETHAFSINFANNVVSNLSKSHINLINNPHRYADFQVLKAPDVPSVLIEIGYLSNKEDEKLLNNPQWRKQMAASIAYSIRQFAEYRQKIMQPL
>T0586 3NEU, Listeria innocua Clip11262, 125 residues	SNAMNPTFHADKPIYSQISDWMKKQMITGEWKGEDKLPSVREMGVKLAVNPNTVSRAYQELERAGYIYAKRGMGSFVTSDKALFDQLKKELADAITERFLEEAKSIGLDDQTAIELLIKRSRNHE
>T0587 3NDV, , 373 residues	GPRARDLGVPFEGTPGALNAITDVAGVEVGHTTVISGDGAMVIGKGPYRTGVTIIHPLGKTSLDGVAAGRAVINGTGEWTGMHLVDEVGQFLGPIALTGTGNVGLVHQSMMDWSVGKVPEEALFSRLLPVVAETLDNRLNDVFGHGLTRDHVFAALDGAKGGPVAEGNVGGGTGMIAYTFKGGIGTSSRVVSAGDTRYTVGVLVQANHGDRNDLRIAGVQIGKEIKGAWPEVNGIVAAGPDAGKPQDKNSLLIVIATDAPLMPHQLERMARRAALGVGRNGSTAGALSGEFALAFSTSHVIPLGGKPRLPAIINDTDSETMNALFRGVVQATEEALVNQLVASETMTGANNAKVYGIPHDQLARIMKARFPRR
>T0588 ZP_02064699.1, Bacteroides ovatus ATCC 8483, 400 residues	MKNLLVCTLLFAYAFTLNAQVANTRIYAAEKLAKVKEKADSPLYAPAVKTLLRDADKALKMTPPSVMDKTMTADSGDKHDYMSMGPYWWPDPSKPDGLPYIRKDGQRNPELDKLDRNKLGDMSKAVTTLGLAYYFSGDEKYAQKAVDFLNVWFLDAKTKMNPHLTYGQTIPGKNKGMGRGAGMIDIYSFTEMIDAMTLMENSKAFTPKVKKGMKEWFTQLVEWMQTSPVAAEEQRAKNNHGLAYDVQLTAYALYTGNQDLAMKTIQEFPEKRLFAQIEPDGKQPLELARTTALGYTIFNLGHMLDMCSIASTLGQDIYNATSQDGRSITAALKFLIPYIGKPQSEWPYQQIKEWDKKQEEACWILRRASFFDPKAGYEAIGAQFRETPANKRIHLIYSLE
>T0589 3NET, Nostoc sp. PCC 7120, 465 residues	SNAMAKNDKINFSTPSGFPEFLPSEKRLELYLLDTIRRVYESYGFTPIETPAVERLEVLQAKGNQGDNIIYGLEPILPPNRQAEKDKSGDTGSEARALKFDQTVPLAAYIARHLNDLTFPFARYQMDVVFRGERAKDGRFRQFRQCDIDVVGREKLSLLYDAQMPAIITEIFEAVNIGDFVIRINNRKVLTGFFQSLNISETQIKSCISIIDNLEKIGEAKVKLELEKEGINPEQTQKIIDFVKIDGSVDDVLDKLKHLSQTLPESEQFNLGVSELETVITGVRNLGVPDKRFCIDLAIARGLNYYTGTVYETTLIGHEALGSICSGGRYEELVGTFIGEKMPGVGISIGLTRLISRLLKAGILNTLPPTPAQVVVVNMQDELMPTYLKVSQQLRQAGLNVITNFEKRQLGKQFQAADKQGIRFCVIIGADEAAAQKSSLKDLQSGEQVEVALADLAEEIKRRLT
>T0590 MaR143A, , 137 residues	MNARDNKFNTWNDSRGNYWSDYEGSDENGDGIGDSAYAVNPEAGSMDYMPLMEYLHSSPVLPTARFTSDITEGFAPLSVRFKDFSENATSRLWMFGDGNTSDSPSPLHTFFNEGEYIVSLIVSNENDSDSASVTIRA
>T0591 YP_354942.1, , 406 residues	MSIEAKFKKLGTDNAPGQEVRQSAAGLEALIRGAPIEGRPVDFSHGDVDAHEPTPGAFDLFSAGVQSGGVQAYTEYRGDLGIRDLLAPRLAAFTGAPVDARDGLIITPGTQGALFLAVAATVARGDKVAIVQPDYFANRKLVEFFEGEMVPVQLDYVSADETRAGLDLTGLEEAFKAGARVFLFSNPNNPAGVVYSAEEIGQIAALAARYGATVIADQLYSRLRYAGASYTHLRAEAAVDAENVVTIMGPSKTESLSGYRLGVAFGSRAIIARMEKLQAIVSLRAAGYSQAVLRGWFDEAPGWMEDRIARHQAIRDELLHVLRGCEGVFARTPQAGSYLFPRLPKLAVAPAEFVKILRLQAGVVVTPGTEFSPHTADSVRLNFSQDHEAAVAAARRIVTLVERYRA
>T0592 3NHV, Bacillus halodurans, 144 residues	ANPNEAYRHYMKKLSYETDIADLSIDIKKGYEGIIVVDVRDAEAYKECHIPTAISIPGNKINEDTTKRLSKEKVIITYCWGPACNGATKAAAKFAQLGFRVKELIGGIEYWRKENGEVEGTLGAKADLFWNMKKESLEHHHHHH
>T0593 3NGW, Archaeoglobus fulgidus, 208 residues	MKVAVLVGGVGRRIGMEKTEVMLCGKKLIEWVLEKYSPFQTVFVCRDEKQAEKLSSRYEAEFIWDLHKGVGSIAGIHAALRHFGSCVVAAIDMPFVKPEVLEHLYKEGEKAGCDALIPKHDYPEPLLAYYAESAADELERAILQGIRKILVPLERLNVVYYPVEKLRKFDKELISFFNINTPDDLKRAEEICSKMSTEGLLEHHHHHH
>T0594 pfc0360w, Plasmodium Falciparum, 140 residues	GMSFEITEEYYVPPEVLFNAFTDAYTLTRLSRGSLAEVDLKVGGKFSLFSGSILGEFTEITKPHKIVEKWKFRDWNECDYSTVTVEFISVKENHTKLKLTHNNIPASNKYNEGGVLERCKNGWTQNFLHNIEVILGYPKK
>T0595 HR4403E, , 123 residues	MNPDLALEEKNKGNECFQKGDYPQAMKHYTEAIKRNPKDAKLYSNRAACYTKLLEFQLALKDCEECIQLEPTFIKGYTRKAAALEAMKDYTKAMDVYQKALDLDSSCKEAADGYQRCMMAQYN
>T0596 3NI7, Nitrosomonas europaea ATCC 19718, 213 residues	MTINNDPMRDAIVDTAVELAAHTSWEAVRLYDIAARLAVSLDEIRLYFREKDELIDAWFDRADSRMLKEAESAGFLDLVASERIHHLIMIWLDALAVQRKVTRQMIMSKLEFGHIHIQIPAVMRVSRTVQWVREAAQRDATFMRRALEESTLTTIYLMTFFFWMRDESENSRHTRQFLKRHLTMAAWLGQKVYGKDPEKSTVPHKQQIPLQFD
>T0597 3NIE, , 429 residues	MHHHHHHSSGRENLYFQGAIIKNVKVPDNYEIKHLIGRGSYGYVYLAYDKNANKNVAIKKVNRMFEDLIDCKRILREITILNRLKSDYIIRLHDLIIPEDLLKFDELYIVLEIADSDLKKLFKTPIFLTEQHVKTILYNLLLGEKFIHESGIIHRDLKPANCLLNQDCSVKICDFGLARTINSDKDIHIVNDLEEKEENEEPGPHNKNLKKQLTSHVVTRWYRAPELILLQENYTNSIDIWSTGCIFAELLNMMKSHINNPTNRFPLFPGSSCFPLSPDHNSKKVHEKSNRDQLNIIFNVIGTPPEEDLKCITKQEVIKYIKLFPTRDGIDLSKKYSSISKEGIDLLESMLRFNAQKRITIDKALSHPYLKDVRKENLENFSTEKIILPFDDWMVLSETQLRYIFLKEIQSFHADLIIPAKLNIHQKSF
>T0598 3NJC, Bacillus subtilis, 161 residues	MAGDPMKSKFEASIDNLKEIEMNAYAYGLIREIVLPDMLGQDYSSMMYWAGKHLARKFPLESWEEFPAFFEEAGWGTLTNVSAKKQELEFELEGPIISNRLKHQKEPCFQLEAGFIAEQIQLMNDQIAESYEQVKKRADKVVLTVKWDMKDPVLEHHHHHH
>T0599 IDP1205, , 399 residues	MNEFTAVKELSEKLLEDYKTESSFFFASPTRTILAEGEFTTVKHHEIESFPELVQAVLRNAKQAGNPNPIVVGALPFDRRKEVQLIVPEYSRISERLQLDPTNHLEINRNLTFEMTPVPDHEVYMKGVKQGIEKIKDGDLKKIVLSRSLDVKSSGKIDKQKLLRELAEHNKHGYTFAVNLPKDENENSKTLIGASPELLVSRHGMQVISNPLAGSRPRSDDPVEDKRRAEELLSSPKDLHEHAVVVEAVAAALRPYCHTLYVPEKPSVIHSEAMWHLSTEVKGELKNPNTSSLELAIALHPTPAVCGTPMEEAREAIQKIEPFDREFFTGMLGWSDLNGDGEWIVTIRCAEVQENTLRLYAGAGVVAESKPEDELAETSAKFQTMLKALGLNDSSLNEK
>T0600 3NJA, Chromobacterium violaceum ATCC 12472, 125 residues	SNAMAEKLLHTAESDAGIGSWVLHMESGRLEWSQAVHDIFGTDSATFDATEDAYFQRVHPDDRARVRRELDRHVLGDRPFDVEYRIVRPDGQVRELLERNHIQRQASGQVDHLWGTVIDMTEHKQ
>T0601 APC5750, , 449 residues	MSLHAAAVGPSVLPDLREQVEQIIAEARRQGASACEVAVSLEQGLSTSVRQGEVETVEFNRDQGFGITLYAGQRKGSASTSATGEAAIRETVAAALAIARHTSEDECAGLADAALMARELPELDLYHPWSLSPEQAVERALACEAAAFAADKRVTKADGTTLNTHQGCRVYGNSHGFIGGYASTRHSLSCVMIAEGEGQMQRDYWYDVNRRGEALASAESIGRRAAERAASRLGARPVQTAEVPVLFAPEIAVGLFGHFLGAISGGSLYRKSSFLEGALGQRLFPEWLSIDERPHLVGALGSASFDSDGLATYAKPFVENGELVSYVLGTYSGRKLGLPSTANAGGVHNLFVSHGDEDQAALIRRMERGLLVTELMGQGVNLVTGDYSRGAAGYWVENGEIQFPVQEVTIAANLRDLFRRIVAVGKDIERRGNLHTGSVLVESMMVAGR
>T0602 3NKZ, Yersinia enterocolitica, 123 residues	SNAMERHQHLLSEYQQILTLSEQMLVLATEGNWDALVDLEMTYLKAVESTANITISSCSSLMLQDLLREKLRAILDNEIEIKRLLQLRLDRLSDLVGQSTKQQAVNNTYGQFPDHALLLGETQ
>T0603 CRISPR associated protein Cas1 , E.coli, 305 residues	MTWLPLNPIPLKDRVSMIFLQYGQIDVIDGAFVLIDKTGIRTHIPVGSVACIMLEPGTRVSHAAVRLAAQVGTLLVWVGEAGVRVYASGQPGGARSDKLLYQAKLALDEDLRLKVVRKMFELRFGEPAPARRSVEQLRGIEGSRVRATYALLAKQYGVTWNGRRYDPKDWEKGDTINQCISAATSCLYGVTEAAILAAGYAPAIGFVHTGKPLSFVYDIADIIKFDTVVPKAFEIARRNPGEPDREVRLACRDIFRSSKTLAKLIPLIEDVLAAGEIQPPAPPEDAQPVAIPLPVSLGDAGHRSS
>T0604 3NLC, Vibrio parahaemolyticus, 549 residues	MGHHHHHHSHMIRINEIKLPLDHEEGALLDAITKKLGIPAEKVISFNVFRRGYDARKKTNIHLIYTLDIIVEGDETALLAKFANDPHVRQTPDMEYKFVAKAPENLTERPIVIGFGPCGLFAGLVLAQMGFNPIIVERGKEVRERTKDTFGFWRKRTLNPESNVQFGEGGAGTFSDGKLYSQVKDPNFYGRKVITEFVEAGAPEEILYVSKPHIGTFKLVTMIEKMRATIIELGGEIRFSTRVDDLHMEDGQITGVTLSNGEEIKSRHVVLAVGHSARDTFEMLHERGVYMEAKPFSVGFRIEHKQSMIDEARFGPNAGHPILGAADYKLVHHCKNGRTVYSFCMCPGGTVVAATSEEGRVVTNGMSQYSRAERNANSAIVVGISPEVDYPGDPLAGIRFQRELESNAYKLGGENYDAPAQKIGDFLKGRDPSQLGDVEPSFTPGIKLTDLSKALPPFAVEAIREAIPAFDRKIKGFASEDGLLTGVETRTSSPVCIKRGKDFQSVNLKGFYPAGEGAGYAGGILSAGIDGIKVAEAVARDIVAAMENA
>T0605 3NMD, , 72 residues	MRGSHHHHHHGMASIEGRGSLRDLQYALQEKIEELRQRDALIDELELELDQKDELIQMLQNELDKYRSVIRP
>T0606 ZP_02040151.1, Ruminococcus gnavus , 169 residues	MKRRLILLVVVIALIAGFGALLHSPPSIIDAVTGATPKAKKAAQSSAQLEGSYIFCMNPLLDKLSDEDIREQLKAFVTGKTDSIRTDTELSFDIYVSETDYALIRYADSLCERLNDAGADVQIKQYSGTMLRSRAVSGKYEAFLSESDLVSTDALENADYIILDSAEMR
>T0607 YP_094844.1, LEGIONELLA PNEUMOPHILA , 471 residues	MFKPQGLYDYICQQWQEEILPSLCDYIKIPNKSPHFDAKWEEHGYMEQAVNHIANWCKSHAPKGMTLEIVRLKNRTPLLFMEIPGQIDDTVLLYGHLDKQPEMSGWSDDLHPWKPVLKNGLLYGRGGADDGYSAYASLTAIRALEQQGLPYPRCILIIEACEESGSYDLPFYIELLKERIGKPSLVICLDSGAGNYEQLWMTTSLRGNLVGKLTVELINEGVHSGSASGIVADSFRVARQLISRIEDENTGEIKLPQLYCDIPDERIKQAKQCAEILGEQVYSEFPWIDSAKPVIQDKQQLILNRTWRPALTVTGADGFPAIADAGNVMRPVTSLKLSMRLPPLVDPEAASVAMEKALTQNPPYNAKVDFKIQNGGSKGWNAPLLSDWLAKAASEASMTYYDKPAAYMGEGGTIPFMSMLGEQFPKAQFMITGVLGPHSNAHGPNEFLHLDMVKKLTSCVSYVLYSFSQKK
>T0608 ZP_02041710.1, Ruminococcus gnavus, 279 residues	MRHRYISYFAGIFLLAFFAVLNTGVLISVSGFQRLQKPVVSQPDFRRQPVSETMQVYLKQAADPGRDVGLYWMATDFENRRFPGKVSPSGFQKLYRQWRNQTGWDAYVQSCRAIWNDVKYFPIPQSLDDTEDKISYVDSWMFERNYGGKRGHEGTDIMAEKNTPGYYPVVSMTDGVVTEKGWLEKGGWRIGITAPTGAYFYYAHLDSYAELEKGDPVKAGDLLGYMGDSGYGEEGTTGEFPVHLHLGIYLKEGTEEISVNPYPVLRYAENARIKCVYSR
>T0609 NP_347334.1, CLOSTRIDIUM ACETOBUTYLICUM, 340 residues	MNNKDLWIKEEIIWSEHKCIRFAAGGYEALIIPDVGGNVVELKDTNKGVTILRTPKKDLKFEDFKNRPQVYGLPVLFPPNRIDDGTFKLGDKTYKFPINEAKNNNYIHGFIKNSKWTVHKKKIDQDKALVEVVFDFTKENEAYKYFSHEFQFKLSYELSSKGLKQTTSVVNLSSEEMPLSVGYHSAFNVPFIEGSEDSNCRVKISIDKFWKQDSRNLPTGESFAPTGEQKEYLENGVAVASHPIESLFSLKDIDVNGKTFRGACIEDASKNTRVVYEMSSEYKYLVIWNDMGDKKYACIEPQTSIINSPNVKLDRSVSGFKTLKPNESWSGVCKLYIENM
>T0610 YP_324426.1  , Anabaena variab ilis ATCC 29413, 186 residues	MVQTPSKPITLDEFLKLPETEPASEYIEGKIIQKPMPQGKHSAIQSECVSVINSVVKPQRIARAFLELRCTFGDHSTVPDISVFIWSRIPREENGEIANIFLIAPDWTIEILSPDQSQTKVTKNILHCLKHGTQMGWLIDPDEQTVFVYRPQQETEVFDEPDALVPVPSFASELHLSIKDLFSWLL
>T0611 YP_960827.1, Marinobacter aquaeolei vt8, 227 residues	MTMKTRDKILLSSLELFNDKGERNITTNHIAAHLAISPGNLYYHFRNKSDIIYEIFQEYEKLVDYYLDIPEDRPITLEDMTFYLESVFDGLWSYRFFHRDLEYLLDSDPRLRQDYREFTNRCLAAINRIFAKLADAGIIQPQPEDLRSAMSLNVWLVITNWMAFLKTAHAAEEPASLSLTELKQGIYQVLTLEVPYLTPEYRERVLALREKYRPTLPEAQGISGVEA
>T0612 YP_001093860.1, Shewanella loihica PV-4, 129 residues	MNKGLVLACLLLGLSACAPHTGGIMISSTGEVRVDNGSFHSDVDVSAVTTQAEAGFLRARGTIISKSPKDQRLQYKFTWYDINGATVEDEGVSWKSLKLHGKQQMQVTALSPNATAVRCELYVREAISN
>T0613 NP_949368.1, RHODOPSEUDOMONAS PALUSTRIS CGA009, 287 residues	MPHHQYVLTLSCPDRAGIVSAVSTFLFENGQNILDAQQYNDTESGHFFMRVVFNAAAKVIPLASLRTGFGVIAAKFTMGWHMRDRETRRKVMLLVSQSDHCLADILYRWRVGDLHMIPTAIVSNHPRETFSGFDFGDIPFYHFPVNKDTRRQQEAAITALIAQTHTDLVVLARYMQILSDEMSARLAGRCINIHHSFLPGFKGAKPYHQAFDRGVKLIGATAHYVTSALDEGPIIDQDVERISHRDTPADLVRKGRDIERRVLSRALHYHLDDRVILNGRKTVVFTD
>T0614 Sin1, Homo Sapiens, 135 residues	GSHHYKSFKVSMIHRLRFTTDVQLGISGDKVEIDPVTNQKASTKFWIKQKPISIDSDLLCACDLAEEKSPSHAIFKLTYLSNHDYKHLYFESDAATVNEIVLKVNYILESRASTARADYFAQKQRKLNRRTSGNS
>T0615 3NQW, , 179 residues	MATYPSAKFMECLQYAAFKHRQQRRKDPQETPYVNHVINVSTILSVEACITDEGVLMAALLHDVVEDTDASFEDVEKLFGPDVCGLVREVTDDKSLEKQERKRLQIENAAKSSCRAKLIKLADKLDNLRDLQVNTPTGWTQERRDQYFVWAKKVVDNLRGTNANLELKLDEIFRQRGLL
>T0616 Ryanodine receptor, Bacteroides thetaiotaomicron, 103 residues	SNAMKENKLDYIPEPMDLSLVDLPESLIQLSERIAENVHEVWAKARIDEGWTYGEKRDDIHKKHPCLVPYDELPEEEKEYDRNTAMNTIKMVKKLGFRIEKED
>T0617 3NRV, Acinetobacter sp. ADP1, 148 residues	SNAMQKINIDRHATAQINMLANKLMLKSSTAYTQKFGIGMTEWRIISVLSSASDCSVQKISDILGLDKAAVSRTVKKLEEKKYIEVNGHSEDKRTYAINLTEMGQELYEVASDFAIEREKQLLEEFEEAEKDQLFILLKKLRNKVDQM
>T0618 3NRH, Bacteroides fragilis, 182 residues	MKKESQVIFDKNVIEFVTVAAEFCAFLERAESMKRSTFVDTTLKILPLLYLKASMLPKCEMIGDESPETYVTEEIYEVLRINLASILAEKDDYLEVFLPDMAYSDEPIKKNISEDLADIYQDIKDFIFVFQLGLNETMNDSLAICQENFGLLWGQKLVNTMRALHDVKYSPKARLEHHHHHH
>T0619 HmR208A, Haloarcula marismortui, 111 residues	LSPREARDRYLAHRQTDAADASIKSFRYRLKHFVEWAEERDITAMRELTGWKLDEYETFRRGSDVSPATLNGEMQTLKNWLEYLARIDVVDEDLPEKVHVPTILEHHHHHH
>T0620 INPPL1B, Homo Sapiens, 312 residues	EPDMISVFIGTWNMGSVPPPKNVTSWFTSKGLGKTLDEVTVTIPHDIYVFGTQENSVGDREWLDLLRGGLKELTDLDYRPIAMQSLWNIKVAVLVKPEHENRISHVSTSSVKTGIANTLGNKGAVGVSFMFNGTSFGFVNCHLTSGNEKTARRNQNYLDILRLLSLGDRQLNAFDISLRFTHLFWFGDLNYRLDMDIQEILNYISRKEFEPLLRVDQLNLEREKHKVFLRFSEEEISFPPTYRYERGSRDTYAWHKQKPTGVRTNVPSWCDRILWKSYPETHIICNSYGCTDDIVTSDHSPVFGTFEVGVTS
>T0621 3NKG, , 172 residues	NPNPISIPIDLSQAGSVVEKEVKIEESWSYHLILQFAVHDRKEDGGLDGKRVWKFLGFNSYDPRDGKQVGYVDYRLAKSELGDLIDETYDCDGTVVPIKITIHQINQDNTKKLIADNLYMTKGNGSGAYTRDITTISLDKGKYIFRIENIEAFSEMIGRKVDFTIYINKRDK
>T0622 3NKL, , 138 residues	KKKVLIYGAGSAGLQLANMLRQGKEFHPIAFIDDDRKKHKTTMQGITIYRPKYLERLIKKHCISTVLLAVPSASQVQKKVIIESLAKLHVEVLTIPNLDDLVNGKLSIGQLKEVSIDDLLGRVAVTPQAELMEANIKD
>T0623 3NKH, , 220 residues	YLELNEIESIIKDINTKAQKMHSGIHKRFYLFVALMTEFQALNGMRIGEMLAIQNEDIDFDNKSLNINGTIHWFHDESGGFGVKDTTKTESSYRTIGLSSRSCEILKKAILENKKDSKWNDGYLNRNFVFTNHKGNPMQTERFNKILREAAKDVGIDKEVSSHILRHSHISLLSQQGVSLKAIMDRVGHSDHRTTLSIYSHVTEQMDKDMMNKLEQVKLG
>T0624 RUMGNA_01417, Ruminococcus gnavus, 81 residues	MSEHREGTLFYDTETGRYDIRFDLESFYGGLHCGECFDVKVKDVWVPVRIEMGDDWYLVGLNVSRLDGLRVRMLEHHHHHH
>T0625 YP_612324.1, SILICIBACTER SP. TM1040, 233 residues	MTSFDRPFEAARPDGENPSAHETLAEGGRLRPEATYTIPARQGRAIRMAQGEALMVINRDGSQIGDFWAFVEGDCGEYLSMEHLRPTLRRVSPRPGDVLVSNRRRPILTLLEDSSPGVHDTLVASCDVHRYAQLGHEGYHDNCTDNLRMALGALGLRPTTVPCPLNLWMNTPVVEGGAMEWRPPVSRRGDHVLFRAELDVVVVISCCPMDLLPINGEEAQPRALDVRLRPRPA
>T0626 NP_794070.1, Pseudomonas syringae pv. tomato str. DC3000, 283 residues	MRTFRLVIACPDRVGIVAKVSNFLASHNGWITEASHHSDNLSGWFFMRHEIRADTLPFDLDGFREAFTPIAEEFSMDWRITDSAQKKRVVLMASRESHCLADLLHRWHSDELDCDIACVISNHQDLRSMVEWHDIPYYHVPVDPKDKEPAFAEVSRLVGHHQADVVVLARYMQILPPQLCREYAHQVINIHHSFLPSFVGAKPYHQASLRGVKLIGATCHYVTEELDAGPIIEQDVVRVSHRDSIENMVRFGRDVEKMVLARGLRAHLEDRVLVHDNKTVVFD
>T0627 NP_791563.1, Pseudomonas syringae pv. tomato str. DC3000, 261 residues	MIDTFERTGPLMEASSYPAWAQQLINDCSPAKARVVEHELYQQMRDAKLSPQIMRQYLIGGWPVVEQFAVYMAKNLTKTRFGRHPGEDMARRWLMRNIRVELNHADYWVNWCAAHDVTLEDLHDQRVAPELHALSHWCWQTSSSDSLAVAMAATNYAIEGATGEWSAVVCSTGVYAEAFAEETRKKSMKWLKMHAQYDDAHPWEALEIICTLVGNKPSLQLQAELRQAVTKSYDYMYLFLERCIQLDKVKSPRGRVAALEM
>T0628 APC38818, Klebsiella pneumoniae, 295 residues	SNAMTARYIAIDWGSTNLRAWLYQGEECLESRQSEAGVTRLNGRSPAAVLAEITQHWRDGATPVVMAGMVGSNVGWKIAPYLPLPAAFSDIGQQLTAVGDNIWIIPGLCVSRDDNHNVMRGEETQLLGARALAPSSVYVMPGTHCKWVLADRRQIHDFRTVLTGELHHLLLQLSLVGAGLPPQETSAAAFAAGLQRGINNPAVLPQLFEVRASHVLGALPREQVSEFLSGLLIGAEVATLSDTFAGQQAISLVAGSSLTSRYQQAFAAIGREVSAVAGDTAFQTGIRSIAYAVAN
>T0629 long tail fibre protein gp37, bacteriophage T4, 216 residues	SSYPIGAPIPWPSDSVPAGFALMEGQTFDKSAYPKLAVAYPSGVIPDMRGQTIKGKPSGRAVLSAEADGVKAHSHSASASSTDLGTKTTSSFDYGTKGTNSTGGHTHSGSGSTSTNGEHSHYIEAWNGTGVGGNKMSSYAISYRAGGSNTNAAGNHSHTFSFGTSSAGDHSHSVGIGAHTHTVAIGSHGHTITVNSTGNTENTVKNIAFNYIVRLA
>T0630 NP_001128980.1, , 132 residues	MRAPIPEPKPGDLIEIFRPFYRHWAIYVGDGYVVHLAPPSEVAGAGAASVMSALTDKAIVKKELLYDVAGSDKYQVNNKHDDKYSPLPCSKIIQRAEELVGQEVLYKLTSENCEHFVNELRYGVARSDQVRD
>T0631 AaR89, , 303 residues	QSFNSGSTKIHNAFPEESTRPQKAEGNTAMNILVLGSDSRGSSDADVEANTATDQRADTLMLVHVPADRKKTYAISLMRDLWIDIPGVGESKINAALAYGGVPLMVQTVESLLQQRIDHVAMIDFQGFKGLTDALGGVEVDVRIPFAPSSGPKAGQVYDAGKQTLNGDEALAFVRERKAFSDGDYQRVRNQQAYLKAIIGKVIARETLTNPVTISNMVSAVSPFVSVDKDFDAAAIGSLALSMKDVRAQDTVMFTLPTLGTGTSPDGQSIVLADTTAIADVTAALAKDQVDAYITAHALDKGF
>T0632 BhR199, , 168 residues	MDKRLQQDRIVDKMERFLSTANEEEKDVLSSIVDGLLAKQERRYATYLASLTQIESQEREDGRFEVRLPIGPLVNNPLNMVHGGITATLLDTAMGQMVNRQLPDGQSAVTSELNIHYVKPGMGTYLRAVASIVHQGKQRIVVEGKVYTDQGETVAMGTGSFFVLRSRG
>T0633 cgr109a , , 462 residues	MLFERIYEEGLAQASYFIGCQREGKAIVVDARRDIQTYLDLAAKNNMVISAVTETHIHADYLSGTRELAAATGAEIFLSGEGGADWQYGFTGTTLMHNSTIKLGNITITAKHTPGHTPEHLSFLITDGAVSKDPGFMLSGDFVFVGDVGRPDLLDEAAGGVDTRFAGAQQLFHSLKEQFLALPDHIQVYPGHGAGSPCGKALGAIPSTTVGYEKANAWWAPYLRSDDEAGFVEELLDGQPDAHAYFARMKKQNKQGPAVLSTLSPLVKLEAEEVVEKLGSEAVFVDTREQNQVHLGTVVGALNIPRGAKASNFAAWVIDPQKDAQDLIVLAPDANTAADFRDALLRVGIDTVRYFTNSIDGLPTFVPELISPAELAETNYDALIDIRAKSEFAAGSIPGAQQLSGGSAMWRLNELPAGGTLVTFCQSGARNTVVANALRRAGFTVIELEGSYAAWEKSAANP
>T0634 3N53, , 140 residues	MSLKKILIIDQQDFSRIELKNFLDSEYLVIESKNEKEALEQIDHHHPDLVILDMDIIGENSPNLCLKLKRSKGLKNVPLILLFSSEHKEAIVNGLHSGADDYLTKPFNRNDLLSRIEIHLRTQNYYSDLRKNEGHHHHHH
>T0635 3N1U, , 191 residues	MSLNTEIEMNELLEKAKKIKCLICDVDGVLSDGLLHIDNHGNELKSFHVQDGMGLKLLMAAGIQVAIITTAQNAVVDHRMEQLGITHYYKGQVDKRSAYQHLKKTLGLNDDEFAYIGDDLPDLPLIQQVGLGVAVSNAVPQVLEFADWRTERTGGRGAVRELCDLILNAQNKAELAITGYLKQEGHHHHHH
>T0636 YP_108324.1, BURKHOLDERIA PSEUDOMALLEI, 336 residues	MSVGEAMDTEVRAAAQAVCLAFNENPEAVEPRVQAAIAAAAARINRYPFDAEPRVMRKLAEHFSCPEDNLMLVRGIDECFDRISAEFSSMRFVTAWPGFDGYRARIAVSGLRHFEIGLTDDLLLDPNDLAQVSRDDCVVLANPSNPTGQALSAGELDQLRQRAGKLLIDETYVDYSSFRARGLAYGENELVFRSFSKSYGLAGLRLGALFGPSELIAAMKRKQWFCNVGTLDLHALEAALDNDRAREAHIAKTLAQRRRVADALRGLGYRVASSEANFVLVENAAGERTLRFLRERGIQVKDAGQFGLHHHIRISIGREEDNDRLLAALAEYSDHS
>T0637 NP_249547.1, PSEUDOMONAS AERUGINOSA, 146 residues	DSASQAEQFLKLVHADKLTVPVYAQVQQMLAQRFAQAKAPESKKAVLERYQAKANAELDRAIGWDKIKPELIKLYTTNFTESELKDLNAFYQSPLGKKVLEKMPRLTAESAQLTQAKLQGAVEPVNKLMADMDKELGVAAPAQKKK
>T0638 3NXH, Bacillus subtilis, 269 residues	MKKKPFSILFMGIEDYATKGQKGRSDSLIVVTLDPKNKTMKMLSIPRDTRVQLAGDTTGSKTKINAAYSKGGKDETVETVENFLQIPIDKYVTVDFDGFKDVINEVGGIDVDVPFDFDEKSDVDESKRIYFKKGEMHLNGEEALAYARMRKQDKRGDFGRNDRQKQILNALIDRMSSASNIAKIDKIAEKASENVETNIRITEGLALQQIYSGFTSKKIDTLSITGSDLYLGPNNTYYFEPDATNLEKVRKTLQEHLDYTPLEHHHHHH
>T0639 3NYM , Neisseria meningitidis MC58, 128 residues	SNAMETLNDIKKILINVGLYQGFDLTDPKVSEEVNHETANMKWIKDYTSDGNWDNEFKEDLKNFLDYMEVCQLALNDKNFKIASNSLFMAMIYAGNLSLIFDSIKTDISTLLSAEYKKNSFSWPSLDE
>T0640 3NYW, Bacteroides thetaiotaomicron, 250 residues	MSLEKQKGLAIITGASQGIGAVIAAGLATDGYRVVLIARSKQNLEKVHDEIMRSNKHVQEPIVLPLDITDCTKADTEIKDIHQKYGAVDILVNAAAMFMDGSLSEPVDNFRKIMEINVIAQYGILKTVTEIMKVQKNGYIFNVASRAAKYGFADGGIYGSTKFALLGLAESLYRELAPLGIRVTTLCPGWVNTDMAKKAGTPFKDEEMIQPDDLLNTIRCLLNLSENVCIKDIVFEMKKSIIEGHHHHHH
>T0641 3NYI, Eubacterium ventriosum, 296 residues	SNAMYKIVSDSACDLSKEYLEKHDVTIVPLSVSFDGETYYRDGVDITRDECYQRMVDDPKLFPKTSLPSVESYADVFRSFVEQGFPVVCFTITTLFSGSYNSAINAKSLVLEDYPDANICVIDSKQNTVTQALLIDQFVRMLEDGLSFEQAMSKLDALMASARIFFTVGSLDYLKMGGRIGKVATAATGKLGVKPVIIMKDGDIGLGGIGRNRNKLKNSVLQVAKKYLDENNKDNFIVSVGYGYDKEEGFEFMKEVESTLDVKLDSETNVAIGIVSAVHTGPYPIGLGVIRKYETL
>T0642 J0KE1, Homo sapiens, 387 residues	MDEARCASPERSTERRIFICNEWSYESTERDAYWERELEASEDTHELASTSEQINTHENINTHCASPPLEASEGETRESTEDANDLETASSESSMENTDETERMINETHEESTSCIENTIFICCENTERSTHISTARGETISDIFFERENTANDHASVERYSPECIFICSHAPEWILLCHECKITATTHEMEETINGINPACIFICGRVEHAHALASTWCFINALISTSITALYANDFRANCEWEREELIMINATEDINPRELIMINARYMATCHESSPAINWINAGAINSTNETHERLANDSINFINALINTERESTINGENDINGHAVEANICEFALLMERRYCHRISTMASANDHAPPYNEWYEARTAKEITEASYANDSMILE
>T0643 3NZL, Homo sapiens, 83 residues	MGHHHHHHSHMLPPEQWSHTTVRNALKDLLKDMNQSSLAKECPLSQSMISSIVNSTYYANVSAAKCQEFGRWYKHFKKTKDMM
>T0644 GS13193H, , 166 residues	MKFLKFSLLTAVLLSVVFAFSSCGDDDDTGYLPPSQAIQDALKKLYPNATAIKWEQKGVYYVADCQADGREKEVWFDANANWLMTETELNSINNLPPAVLTAFMESSYNNWVVDDVVILEYPNEPSTEFVVTVEQGKKVDLYFSEGGGLLHEKDVTNGDDTHWPRV
>T0645 GS7807M, , 537 residues	MKSSKYISILCVGSLLSLASCTDGFESDNKINGSFDDTVKEYDFQKYTTNFETIQKGIYFNYDWGEGTTWPWQTFQNLNHDMFSGYFHDFASKFSDKNTVYALEAGWTASAWNYTYNYIFPVAHKSTLITQDEAKYKHFYGATLILKVEAMHRITDTYGPIVYSKFGKNETNSVDTQEEAYKAFFDDLDKAVDALDTYLKEGGKEDGVKSINMCNCPTASRWIKFANSLRLRLAMRVSNVDKTLATSEAQKALENSYGVIESSDENIQISGKGYQNPLAGVAGWGETYMGATIASVLNGYEDPRISIYYNPATLAEHTEEYLGVPQGVYAKDGDPNYYQSYSFINTQTITASTPAVLLTAAETWFLRAEASLRGINPKNESAKQCYEAGVQTSFSQWGAGDASLYLTSKGKPTDYINYAAGPGKDMKALITTTPNFDDAVNQEEQLEKIITQKWIACWPEGMEAWAEQRRTGYPKLFKVQTNNSNGTIDTDIMIRRLPFSQDDAKKDPEQYKNLCTALGGADNGGTRLWWDTGKNNF
>T0646 OR188, , 93 residues	MQEERKKLLEKLEKILDEVTDGAPDEARERIEKLAKDVKDELEEGDAKNMIEKFRDEMEQMYKDAPNAVMEQLLEEIEKLLKKAGSLVPRGSY
>T0647 HR5514A, , 157 residues	MTERLSAEQIKEYKGVFEMFDEEGNGEVKTGELEWLMSLLGINPTKSELASMAKDVDRDNKGFFFNCDGFLALMGVYHEKAQNQESELRAAFRVFDKEGKGYIDWNTLKYVLMNAGEPLNEVEAEQMMKEADKDGDRTIDYEEFVAMMTGESFKLIQ
>T0648 CpN10, , 102 residues	MAGQAFRKFLPLFDRVLVERSAAETVTKGGIMLPEKSQGKVLQATVVAVGSGSKGKGGEIQPVSVKVGDKVLLPEYGGTKVVLDDKDYFLFRDGDILGKYVD
>T0649 GS13209C, , 210 residues	MKKLIPILLAVFALASCEKDPDMGKLDDNYLVYTNYDKQANFKDFSTFYLADKILVISDSKEPEYLEGEGAEQILAAYTENMEAKGYQPAADKESADLGIQVSYIASTYYFTGYTQPEWWWGYPGYWGPSYWGNWGGWYYPYAVTYSYSTNSFITEMVNLKADEGEGKKLPVVWTSYLTGFETGSKAINRTLAIEAVNQSFTQSPYLTNK
>T0650 EL17883H, , 346 residues	AATLATLPAPINQIFPDADLAEGIRAVLQKASVTDVVTQEELESITKLVVAGEKVASIQGIEYLTNLEYLNLNGNQITDISPLSNLVKLTNLYIGTNKITDISALQNLTNLRELYLNEDNISDISPLANLTKMYSLNLGANHNLSDLSPLSNMTGLNYLTVTESKVKDVTPIANLTDLYSLSLNYNQIEDISPLASLTSLHYFTAYVNQITDITPVANMTRLNSLKIGNNKITDLSPLANLSQLTWLEIGTNQISDINAVKDLTKLKMLNVGSNQISDISVLNNLSQLNSLFLNNNQLGNEDMEVIGGLTNLTTLFLSQNHITDIRPLASLSKMDSADFANQVIKK
>T0651 LgR82, , 254 residues	MKDIIIASFYKFIPLNDFESLREPILTKMHEIGIKGTIILAHEGVNGGFAGNREQMNVFYDYLRSDSRFADLHFKETYDNKNPFDKAKVKLRKEIVTMGVQKVDPSYNAGTYLSPEEWHQFIQDPNVILLDTRNDYEYELGTFKNAINPDIENFREFPDYVQRNLIDKKDKKIAMFCTGGIRCEKTTAYMKELGFEHVYQLHDGILNYLESIPESESLWEGKCFVFDDRVAVDQKLDRVYPQLPQDYKYEREQK
>T0652 ER40, , 292 residues	MSDDNSHSSDTISNKKGFFSLLLSQLFHGEPKNRDELLALIRDSGQNDLIDEDTRDMLEGVMDIADQRVRDIMIPRSQMITLKRNQTLDECLDVIIESAHSRFPVISEDKDHIEGILMAKDLLPFMRSDAEAFSMDKVLRQAVVVPESKRVDRMLKEFRSQRYHMAIVIDEFGGVSGLVTIEDILELIVGEIEDEYDEEDDIDFRQLSRHTWTVRALASIEDFNEAFGTHFSDEEVDTIGGLVMQAFGHLPARGETIDIDGYQFKVAMADSRRIIQVHVKIPDDSPQPKLDE
>T0653 SP13177B, , 414 residues	MNKIISIIALLLILPIFKVEAYDFVIDEITYNFTKEHGTVEVSGLREFLNLEPGDRNSSLPLVVNIPPVVTYKDNKYDVVSIGYAAFQGCRKVTEIKIPSTVREIGEFAFENCSKLEIINIPDSVKMIGRCTFSGCYALKSILLPLMLKSIGVEAFKGCDFKEITIPEGVTVIGDEAFATCESLEYVSLPDSMETLHNGLFSGCGKLKSIKLPRNLKIIRDYCFAECILLENMEFPNSLYYLGDFALSKTGVKNIIIPDSFTELGKSVFYGCTDLESISIQNNKLRIGGSLFYNCSGLKKVIYGSVIVPEKTFYGCSSLTEVKLLDSVKFIGEEAFESCTSLVSIDLPYLVEEIGKRSFRGCTSLSNINFPLSLRKIGANAFQGCINLKKVELPKRLEQYRYDFEDTTKFKWIK
>T0654 SP14202R, , 166 residues	MKVRAYVLIASVALLGMSAGSKKAKLTEGVNPGDLAPRIEFLGNDAKASFHNQLGRYTLLNFWAAYDAESRARNVQLANEVNKFGPDKIAMCSISMDEKESIFTETVKIDKLDLSTQFHEGLGKESELYKKYDLRKGFKNFLINDEGVIIAANVTPEKLTEILKAI
>T0655 MiR12, , 182 residues	MASGQATERALGRRTIPAGEARSIIIRQRYDAPVDEVWSACTDPNRINRWFIEPKGDLREGGNFALQGNASGDILRCEPPRRLTISWVYEGKPDSEVELRLSEEGDGTLLELEHATTSEQMLVEVGVGWEMALDFLGMFIRGDLPGGPVPEDAAEEFEPSPEMMRISQERGEAWAALVHSGS
>T0656 CsR251, , 146 residues	MVNINHRIGIKASPEKIYQALTTDDGLKKWWTNDISGAGVVGSTIKFRFNGGGPDFKVTKLIPNKTVCWQHAGNMPESWMGTEISFQLETVENQTFVRFTHSNWHETTDFMAHCNTKWAVFLLSLKDALEIGKGTPFPNDIQIDHS
>T0657 HR3504C, , 154 residues	MNFNTILEEILIKRSQQKKKTSPLNYKERLFVLTKSMLTYYEGRAEKKYRKGFIDVSKIKCVEIVKNDDGVIPCQNKYPFQVVHDANTLYIFAPSPQSRDLWVKKLKEEIKNNNNIMIKYHPKFWTDGSYQCCRQTEKLAPGCEKYNLFESSIR
>T0658 SP16569N, , 541 residues	MKKTFLYFCLLFIVQTAFAADSIYVREQQIPILIDRIDNVLYEMRIPAQKGDVLNEITIQIGDNVDLSDIQAIRLFYSGVEAPSRKGEHFSPVTYISSHIPGNTRKALESYSVRQDEVTAPLSRTVKLTSKQPMLKGINYFWVSIQMKPETSLLAKVATTMPNAQINNKPINITWKGKVDERHVGIGVRQAGDDGSAAFRIPGLVTTNNGTLLGVYDIRYNSSVDLQEKIDIGVSRSTDKGQTWEPMRVAMTFKQTDGLPHGQNGVGDPSILVDEKTNTIWVVAAWTHGMGNERAWWNSMPGMTPDETAQLMLVKSEDDGKTWSEPINITSQVKDPSWYFLLQGPGRGITMQDGTLVFPIQFIDATRVPNAGIMYSKDRGKTWHLHNLARTNTTEAQVAEVEPGVLMLNMRDNRGGSRAVATTKDLGKTWTEHPSSRSALQESVCMASLIKVNAKDNITGKDLLLFSNPNTTKGRNHITIKASLDGGLTWPTEHQVLLDEAEGWGYSCLSMIDKETVGIFYESSVAHMTFQAVKLQDLIHQ
>T0659 SP1554B, , 85 residues	AVVTVDGEVYGTYSLAKDQTIEIQDGNRLRIQNGQAKMEWADCPDQLCVHQKAISRTGESIICLPNQVVVSVQGSKESELDGIVN
>T0660 HR3534I, , 108 residues	MYRALYAFRSAEPNALAFAAGETFLVLERSSAHWWLAARARSGETGYVPPAYLRRLQGLEQDVLQAIDRAIEAVHNTAMRDGGKYSLEQRGVLQKLIHHRKETLSRRG
>T0661 PpR99, , 215 residues	MISILRRGLLVLLAAFPLLALAVQTPHEVVQSTTNELLGDLKANKEQYKSNPNAFYDSLNRILGPVVDADGISRSIMTVKYSRKATPEQMQRFQENFKRSLMQFYGNALLEYNNQGITVDPAKADDGKRASVGMKVTGNNGAVYPVQYTLENIGGEWKVRNVIVNGINIGKLFRDQFADAMQRNGNDLDKTIDGWAGEVAKAKQAADNSPEKSVK
>T0662 PaT415, , 79 residues	MPNDMEDHLLTVLSVASGVPKEEISRDSRMEDLAFDSLVVSELSLKLRKEFGVTGVDDELDLLETVDELFQLVEKHRAA
>T0663 SP19336A, , 205 residues	MCKKTYLLVVSMLIAGLLTACSGSPTKDSGQAQDNTKKEANASNNALKDEKNNENLMEQDFKVPYTDAINIFKDKYKDADIVDLSLERDLNKFVYTVEGVDDNNEYKMKIDANTKDVLEDKTEKLDSEDLNGVARKEKLDLNDIMTPQQAMEIALKEQNGIVKEWSLDKDLDVTFYKIRIDKDKNEYDIKVDSKKGTVLKVEKED
>T0664 SP7807M, , 540 residues	MKKNTIIQFIATGMFLFGATACTGNFEDYNKNPHEPDQNDMGVDWYLVRSLALNLQDLMMPEQENFSQYVDCLMAGAFSGYVADSNLGTGWSGRYATYNPSDDWKKIPFNDFYSKFYPDYFNLKNQSDDELFLSLAELYRIVVMLRVTDTYGPIPYSKVGAANAIKSPYDSQQAVYAKMLEDLDNIITVLGKFGNQSFSSSADRIYNGNTSAWYKFANSLKLRMAMRTCYVAGFNVNGKTSQQLAEEAVAAGVMTAATDGAYRKVADHNPWQRFMVLWSDARISADLTCYMNAYNDPRREAYYDKSTFGTVSGNAYTGEESYVGLRRGILQGQYNSWSQGSSCMKVTTSDNIVVFRASEVAFLRAEGALRNWNMGGTAKDFYEEGIRLSFEENGITSGVENYLASTGKVEAYKDPLKGQSAQTYDYSGAINTNVTVAWSGGDFEKSLEQIITQKWIANFPNGMESWTEYRRTGYPKLMPMAANASGGIVNDAEGARRMPYPTDEYRENRESVEAAVATLTQESKTKRGDTMATHVWWDCK
>T0665 HR8150A, , 67 residues	KNVIKKKGEIIILWTRNDDREILLECQKRGPSFKTFAYLAAKLDKNPNQVSERFQQLMKLFEKSKCR
>T0666 UCI_BBCS, , 195 residues	MLGLVLLYVGIVLISNGICGLTKVDPKSTAVMNFFVGGLSIVCNVVVITYSALHPTAPVEGAEDIVQVSHHLTSFYGPATGLLFGFTYLYAAINHTFGLDWRPYSWYSLFVAINTVPAAILSHYSDMLDDHKVLGITEGDWWAIIWLAWGVLWLTAFIENILKIPLGKFTPWLAIIEGILTAWIPAWLLFIQHWV
>T0667 YeR85, , 194 residues	MMSTLLYIHGFNSSPSSAKATTFKSWLQQHHPHIEMQIPQLPPYPAEAAEMLESIVMDKAGQSIGIVGSSLGGYFATWLSQRFSIPAVVVNPAVRPFELLSDYLGENQNPYTGQKYVLESRHIYDLKAMQIEKLESPDLLWLLQQTGDEVLDYRQAVAYYTPCRQTVESGGNHAFVGFDHYFSPIVTFLGLATA
>T0668 Prot_22263, Aquifex aeolicus, 86 residues	GSEEKEEKKVRELTPQELELFKRAMGITPHNYWQWASRTNNFKLLTDGEWVWVEGYEEHIGKQLPLNQARAWSWEFIKNRLKELNL
>T0669 YR313A, , 109 residues	MNSQRLIHIKTLTTPNENALKFLSTDGEMLQTRGSKSIVIKNTDENLINHSKLAQQIFLQCPGVESLMIGDDFLTINKDRMVHWNSIKPEIIDLLTKQLAYGEDVISKE
>T0670 CgR157, , 151 residues	MASGKDLQVSTFGYISRCPVQVYEAIADPRQLERYFATGGVSGRLETGSTVYWDFVDFPGAFPVQVVSATQAEHIELRWGQANELRSVNFEFEPFRNFTRTKLTITEGSWPLTPAGAQEALGSQMGWTGMLSALKAWLEYGVNLRDGFYKQ
>T0671 EL17507A, , 428 residues	MKQTRPYIITALCLQMVLGAILLSCSTENDEYKKDSPSAENPAEPVGALLEDFSIEQLPAKTIYALGENIDLTGLNVTGKYDDGKQRPVKVTPEQISGFSSSAPVDKQEVTITIEGKQKSFSVQISPVRVENGVLTEVLKGHNEIILPNSVKSIPKAAFRGSQINKVVLNEGLQSIGDMAFFNSTVQEVVFPTTLEQLEENIFYYCRNLKKADLSRTKLTKLPASTFVYAGVEEVLLPATLKEIGAQAFLKTSQLKTIEIPENVRTIGLEAFRESGITTVKLPNGVTTIAQRAFYYCPELTEVTTYGTVINENPEAMIHPYCLEGCPKLTRFDISKSIRILGQGLLGGNRKVTQLTIPANVTQINFSAFNNTGIKEVMVEGITPPQVFEKVWYGFPDDITVIRVPAESVEKYKNANGWKDFTNKITAF
>T0672 SP16046A, , 335 residues	MSLPRLSLSLCLALACGPALASQAPVYGERLEGFDYAYPVHYLDFTSQGQPLSMAYLDVAPKKANGRTILLMHGKNFCAGTWERTIDVLADAGYRVIAVDQVGFCKSSKPAHYQYSFQQLAANTHALLERLGVARASVIGHSMGGMLATRYALLYPRQVERLVLVNPIGLEDWKALGVPWRSVDDWYRRDLQTSAEGIRQYQQATYYAGEWRPEFDRWVQMQAGMYRGKGRESVAWNSALTYDMIFTQPVVYELDRLQMPTLLLIGEKDNTAIGKDAAPAELKARLGNYAQLGKDAARRIPQATLVEFPDLGHTPQIQAPERFHQALLEGLQTQP
>T0673 SP19319C, Pseudomonas aeruginosa PA01, 88 residues	MKLASVVSAVITSLAPMAFAQDVDKDPGRGLPVEEYHYGMQLDVKNVLHRTDNSTRTGVVPVTVVYEDHSGELHKIRFLEWGGSTSNG
>T0674 SP5305Y, , 340 residues	MKLKITVICSVVFSLFFFLLLFLVIFFADDTDSGENNKDSSIPQGGVTVSPEVLAHRPLIEKYGKEYGIEDYVSYILAIMQVESGGTAEDVMQSSESLGLPPNSLSTEESIKQGVKYFSELLTSAEQQGVDIDSVIQSYNYGGGFLNYVRSHGKKYTYELAEQFSKEKSGGQKADYPNPIAIPVNGGWRYNYGNQFYVQLVSQYLTDTSPTEFDDETVQVIMDEALKYEGFPYVFGGASPTTSFDCSGLIQWVYDKAGISLPRVAQDQYDATQEISMEEAQAGDLIFFHSTYNAGTYVTHVAIYLEGNRFYHAGDPIGYGDLSSRYWQDHLIGARRVIHN
>T0675 HR7614B, , 75 residues	MGDGEGAGVLGLSASAECHLCPVCGESFASKGAQERHLRLLHAAQVFPCKYCPATFYSSPGLTRHINKCHPSENR
>T0676 SP13279C, , 204 residues	MIIMNKFTILFLTLFLALPMAMKADSAKEKKDDTRYLVGAVPEVDGKVVFSKEFQIPGMSQAQIYDTMTKWMDERLKENKNIDSRIVFSDEAKGTIAGVGEEWIVFSSSALSLDRTLVNYQITVTCKPGNCLVELEKIRFTYRETEKYKAEEWITDKYALNKAKTKLVRGLAKWRRKTVDFADDMFMDVAVAFGAPDTRPKTEK
>T0677 HR8011D, , 153 residues	TGKWTEEEEKRLAEVVHELTSTEPGDIVTQGVSWAAVAERVGTRSEKQCRSKWLNYLNWKQSGGTEWTKEDEINLILRIAELDVADENDINWDLLAEGWSSVRSPQWLRSKWWTIKRQIANHKDVSFPVLIKGLKQLHENQKNNPTLLENKSG
>T0678 UP20725R, , 161 residues	MNSLLSRALELQRMAHELMYLDTNGSPIYSDEFCRLNKEVLTRSDSLFSEQSSDIEEEGNLCLALLMGYNATIYDNGDKERKKQVILDRIYNIMSQLPASLLKMRLLTWGYSETYDEELAHEAHQLIETWNISDLTDEQKEIIEELRNFEENQYPWEEVQE
>T0679 SP17517A, , 223 residues	MKHTFITFILLSLCIFTYAQKKIAREYIEWSDIWIPGANKTDLPHVLLIGNSITRGYYGKVEAALKEKAYVGRLSNSKSVGDPALIEELAVVLKNTKFDVIHFNNGLHGFDYTEEEYDKSFPKLIKIIRKYAPKAKLIWANTTPVRTGEGMKEFAPITERLNVRNQIALKHINRASIEVNDLWKVVIDHPEYYAGGDGTHPIDAGYSALANQVIKVIKNVLVH
>T0680 SP19308B, , 119 residues	MSIRWMMAAGLAALTLSGCASNDPAPLEQMRLTEQALEQAKAVGATDDVAELKLAQDKYAAAQIAMTAESYKKARLLAEQAELDARLAESKVLTQKSKDQLGELDKSLKRLRKQLGETD
>T0681 SP13427A, , 224 residues	MKKIIPFFIMICCLLAVSSCSYDNFEEPKATLTGKAIYDGEAVGVRSGSSEFALFQDGYALKGSIPVYIAQDGSYSVSLFNGDYKLVRMGNAPWERPSNDTIYITVRGNTVQDIPVTPYFFVRNVSFAKNGNKITARFTINKVVANANMENVGIYLGTGILTDEKQKEAELKLGNTVSLDQENTAEIEIPSGLVNESYLYARVGVKSDKSSEYCYSQSIKVALK
>T0682 MED12BPR, , 235 residues	MGEILAVDDYVGISFWLAAAIMLASTVFFFVERSDVPVKWKTSLTVAGLVTGVAFWHYLYMRGVWIYAGETPTVFRYIDWLITVPLQIIEFYLIIAAVTAISSAVFWKLLIASLVMLIGGFIGEAGLGDVVVWWIVGMIAWLYIIYEIFLGETAKANAGSGNAASQQAFNTIKWIVTVGWAIYPIGYAWGYFGDGLNEDALNIVYNLADLINKAAFGLAIWAAAMKDKETSTSHA
>T0683 SP19086A, , 403 residues	MVMKTMRLFKGILFTFCGIIFCFNSHAALEHEKLVNYIALGEFSRETAEIALKKMPPLDTLTVHYDLQLYKINYKTQSPDGNLTIASGLVAMPIHPVGQVGIISYQHGTRFERNDVPSRNNEKNYIYLAAYGNSAGYMTVMPDYLGLGDNELTLHPYVQAETLASSSIDMLFAAKELANRLHYPISDKLYLAGYSEGGFSTIVMFEMLAKEYPDLPVSAVAPGSAPYGWEETMHFVMLEPGPRATAYLAYFFYSLQTYKSYWSGFDEIFAPPYNTLIPELMDGYHAVDEILQALPQDPLLIFQPKFSNGIISKTDRNTEILKINFNHYDFKPTAPLLLVGTKGDRDVPYAGAEMAYHSFRKYSDFVWIKSVSDALDHVQAHPFVLKEQVDFFKQFERQEAMNK
>T0684 SP17835A, Bacteroides ovatus ATCC 8483, 270 residues	MRYKKIVLSIIASVLCLGLLNGCGHENEISIKIETYLQEEYGEEFEVLSWNQPKLLPSDNGAIYATCISKNDPKHPFEGSYFNPEEPNSEIEIIYDGYGQRLLAKQMESMIEEAISQAAENYYIQGDIIIPEEWQDIPVEEISQWKNYVDLCNQSNSDYKTLGSAWVYIDASTMKGKTDEEEYQMYEEVYRDKLGGQALLYVYYLDHKSFEKAEKILEIFTSGDEGSNFEDIIEGQPYFGTIMRYGSDKFDDNLEIFKAAKQGKEQEKYQ
>T0685 CC20734A, , 253 residues	MRYFLQAPIAARPRPGLRMAQITAEFAAMTETVTETTAPASPEADVQGPDFAAMLAARLCHDFISPASAIVSGLDLLEDPSAQDMRDDAMNLIASSARKLADLLQFTRVAFGASASAENFDSRELEKLAQGVFAHVRPTLDWQIEPQAMNKPSSRAVLNIAQIAASALPAGGVATVKGVAADGRFSIIADAKGPRARLRPEVLAGLKGEPLAEGLGGPWVQAAYLNALVRAAGGQIAVEIGEDRASIAAWVPA
>T0686 TRP, VIVAX, 259 residues	DEKVVDEVKYSEEVCNEQVDLYLLVDGSGSIGYPNWITKVIPMLNGLINSLSLSRDTINLYMNLFGSYTTELIRLGSGQSIDKRQALSKVTELRKTYTPYGTTSMTAALDEVQKHLNDRVNREKAIQLVILMTDGVPNSKYRALEVANKLKQRNVRLAVIGIGQGINHQFNRLIAGCRPREPNCKFYSYADWNEAVALIKPFIAKVCTEVERVANCGPWDPWTACSVTCGRGTHSRSRPSLHEKCTTHMVSECEEGECP
>T0687 TRAP, Falciparum, 216 residues	RDVQNNIVDEIKYREEVCNDEVDLYLLMDGSGSIRRHNWVNHAVPLAMKLIQQLNLNDNAIHLYASVFSNNAREIIRLHSDASKNKEKALIIIKSLLSTNLPYGKTSLTDALLQVRKHLNDRINRENANQLVVILTDGIPDSIQDSLKESRKLSDRGVKIAVFGIGQGINVAFNRFLVGCHPSDGKCNLYADSAWENVKNVIGPFMKAVCVEVEKT
>T0688 EL17883Q, LISTERIA MONOCYTOGENES, 196 residues	AAEQTGLKASQDNVNIPDSTFKAYLNGLLGQSSTANITEAQMDSLTYITLANINVTDLTGIEYAHNIKDLTINNIHATNYNPISGLSNLERLRIMGTDVTSDKIPNLSGLTSLTLLDISHSAHDDSILTKINTLPKVNSIDLSYNGAITDIMPLKTLPELKSLNIQFDGVHDYRGIEDFPKLNQLYAFSQTIGGKK
>T0689 GS13775B, Parabacteroides distasonis ATCC 8503, 234 residues	MKVKILYTALISLIAGGAMAQDCTFFFPQTEGTVWVRKGYDAKGNLQSVMSYQVDEVETLPSGQEVEADYVYTNPSGTIVNKGDIKAYCQNGEFFLDSKETLSYPGVVSEMNTNVDITENFINYPNPYAANFDKNNVYFDEASVKIYDKKNRKNRKDMAIKDREFIKTESITTPAGTFDCAKVKYNIATRSPKSKETITGYGYEWYSPNVGLVRTEQYDKNNVLQSYTVLEELK
>T0690 EL13177C, Faecalibacterium prausnitzii A2-165, 393 residues	ASDSPMAYTDGSYQFILNADNTATITKYTGNEHRITIPAQVTHGAYIYPVSKIGDRVFCNYKYVLTSVQIPDTVTEIGSNAFYNCTSLKRVTIQDNKPSCVKKIGRQAFMFCSELTDIPILDSVTEIDSEAFHHCEELDTVTIPEGVTSVADGMFSYCYSLHTVTLPDSVTAIEERAFTGTALTQIHIPAKVTRIGTNAFSECFALSTITSDSESYPAIDNVLYEKSANGDYALIRYPSQREDPAFKIPNGVARIETHAFDSCAYLASVKMPDSVVSIGTGAFMNCPALQDIEFSSRITELPESVFAGCISLKSIDIPEGITQILDDAFAGCEQLERIAIPSSVTKIPESAFSNCTALNNIEYSGSRSQWNAISTDSGLQNLPVAPGSIDVTV
>T0691 SP13287B, Bacteroides ovatus ATCC 8483, 163 residues	MKKLYFFTMLSIMLLAVTGAMAQKKTKFKAADLKGIWQLCHYVSESPDVPGALKPSNTFKVLSDDGRIVNFTIIPGADAIITGYGTYKQLTDDSYKESIEKNIHLPMLDNQDNILEFEIKDNDYLHLKYFIKSDLNGNELNTWYYETWKRVEMPAKFPEDIVR
>T0692 APC100005, , 473 residues	MTKTIEVRNPRTGKFDYVIIPPPPRLLAQQCNRARRAQSRWQELGVEGRITTLQQWKQAILSRREQLTEALVNDTGRLSITVLEIDSFLASIDRWCGLAPELLQTSAKNTSIPFIALQQSLVPYPLVGVISPWNFPLTLSMIDTIPALLAGCAVVVKPSEIAPRFVAPLLMALNTVPELRDVLIFVEGGGETGANLINYVDFVCFTGSVATGREVAETAARRFIPAYLELGGKDPAIVLESANLELATSAILWGAVVNTGQSCLSIERIYVAESKFEEFYHQLIAKAHRLQLAYPLVEDGAIGPIIAEKQAGIINDHILDAVEKGAVIHCGGKVEELGGGWWCRPTVMTNVNHSMKVMTEETFGPIMPVMPFPDVEEAVYLANDTIYGLSAAVFAGSEDEALKVARQLNAGAISINDAALTAMMHEGEKNAFNFSGLGGSRVGAAGLKRFLRKQAFLIKTNSTSDPWWFDKGD
>T0693 APC102470, , 319 residues	MIDLAPLVRRLAGTPLAEWANGLQAQLDTKMSKGHGDLQRWQSALDALPALQPEKVDLTDSFTLETECDGETRTVLRKALLGLSPWRKGPFNVFGVHIDTEWRSDWKWSRVSPHLDLKGKRVLDVGCGNGYYQWRMLGAGADSVIGVDPNWLFFCQFQAMQRYLPDLPAWHLPFALEDLPANLEGFDTVFSMGVLYHRKSPIDHLLALKDCLVKGGELVMETLVIPGDVHQVLVPEDRYAQMRNVWFLPSVPALELWMRRAGFTDVRCVDVSHTTVEEQRSTEWMRFQSLGDYLDPNDHSKTVEGLPAPMRAVIVGRKP
>T0694 APC100075, , 315 residues	MVLAYYSGYAGNYAALTRYAASFNAVAVDFYNITAQGAVTGNGDPAPNDAISFLLGRKIPAYGCVSNVDGNGNWSADIAHAVSTSAQSQAVANLVKFAQDKRFSGINVDFEAVAQGDRNNFSHFIQVLGRALHAKGLKLIVSVPAFSAKDENHPANYGYDLRALGAAADYLQIMSYDEAIPAWDPGPVAGSDWMEDDLDYAVERVPAAKILNGIPAYGYDWKRPGDGGMLYWKDTQALIARYGAQPRYDAGTHSLTFNYGAADGSRHTVWTENARSVALKASLVNAYGLGGTSLYALGMEDDAFWAAVKQGLAQR
>T0695 ezra, bacillus subtilis, 536 residues	KIYAEIDRLESWKIEILNRSIVEEMSKIKHLKMTGQTEEFFEKWREEWDEIVTAHMPKVEELLYDAEENADKYRFKKANQVLVHIDDLLTAAESSIEKILREISDLVTSEEKSREEIEQVRERYSKSRKNLLAYSHLYGELYDSLEKDLDEIWSGIKQFEEETEGGNYITARKVLLEQDRNLERLQSYIDDVPKLLADCKQTVPGQIAKLKDGYGEMKEKGYKLEHIQLDKELENLSNQLKRAEHVLMTELDIDEASAILQLIDENIQSVYQQLEGEVEAGQSVLSKMPELIIAYDKLKEEKEHTKAETELVKESYRLTAGELGKQQAFEKRLDEIGKLLSSVKDKLDAEHVAYSLLVEEVASIEKQIEEVKKEHAEYRENLQALRKEELQARETLSNLKKTISETARLLKTSNIPGIPSHIQEMLENAHHHIQETVNQLNELPLNMEEAGAHLKQAEDIVNRASRESEELVEQVILIEKIIQFGNRFRSQNHILSEQLKEAERRFYAFDYDDSYEIAAAAVEKAAPGAVEKIKAD
>T0696 APC100578, , 111 residues	METSVIEASSLKLDDLHHIAISVTDVAQSVEWYTSHFQCRIAYQDSTWALLKFGNLSLALVIPEQHPPHIAFTSDRAGEYGSLKTHRDGTRSCYIQDPSGNSVELMDPTSL
>T0697 APC100677, , 483 residues	MDSRFLPATAFIDPEGRNRNEVERLVQQVVDLILAKLTGAAERPPMPETVDLPGPITIPEAAATEATLLQAIRDMVDGSMNPANPGYIGHMDPMPATMAILGDLVAAAVNNNMLSLEMSPSFSRLETLLLRAIAGLFGLGEQAGGVLTSGGSLANLQALAVARNVAFDSVEPGITGLAQRPVIFASEAAHTSLQKAAMLLGLGTAAVIPVRATADSRMDPEDLRARIDQARGAGQHPFCVVATAGTTTTGNIDPLAEIGAIAREHGLWFHVDAAYGGALVFSERHRWRLAGIEQADSITFNPQKWLYVAKTCAMVLFRDAGVLERAFRIPAPYMRATDGFINLGEIGVQGTRHADVVKLWLTLQHIGQQGYARLIDDGYRLAERVVEGVRQRPFLRLAGEIDTNIVCFRGEPDWLPAERWDDWNAALQALLLREGKIFLSLPVYRGGRWLRAVLLNPYTTDAVIDAMFKQIDRFAGRERGQER
>T0698 MvicOBP3 , , 119 residues	MRFTTEQIDYYGKACNASEDDLVVVKSYKVPSSETGKCLMKCMITKLGLLNDDGSYNKTGMEAGLKKYWSEWSTEKIESINNKCYEEALLVSKEVIATCNYSYTVMACLNKQLDLDKST
>T0699 APC100369, , 234 residues	MIDGKFISAIITAAGSGLRMRSKINKPYIEVGGRKVLEITLDTVSRVKEIDEIILVIRKDDEDIIKDILEKYDGNIRYVYGSTTRELSTFEGLKALDPQSELVLTHDGVRPFASEELFLKTINALRKNKAVITATKSKDTVKIIDDDMYVDFTPNRDYVYNIQTPQAFDKKLIYAMYEKYLASEFKVTDDSQLFEFFDRDEKVKVVHGEYSNIKITTQEDIIFANAYLQRKKDV
>T0700 HR4748B, , 86 residues	GVPYSVLEPVLERCTPDQLYRIEEYNHVLIEETDQLWKVHCHRDFKEERPEEYESWREMYLRLQDAREQRLRVLTKNIQFAHANKP
>T0701 APC100304, , 322 residues	MKLGIFTVLFSQMPFEEMLDHVAAAGVDAVEIGTGGYPGNAHCDREALLASAEKRSAFLNAIASRGLEISALSCHNNPLHPNEEVRQKADQELRETIRLAAELGVKTVVTFSGCPGESERSENPVWVTCPWPEEYSRVLEWQWKEKVIPYWTEMNRFAADHGVRIAIEAHPGFVVYNGETLLRLRDACGEQIGINFDPSHMFWQGIDPIEAVHALAPHRCIFHVHAKDTGFNKHNVARDGVLDTKPYREELKRAWIFRTVGYGHDQQTWADLLSALQMNGYDGVISIEHEDSLMSIEEGFQKAVAFLRPLVIREKLQQMWWA
>T0702 APC100239, , 271 residues	MSHIHFIGSGQMSEAMIRAIIKHKTASASDITAYDIRPEREKELHDNYGITTFAKPKKNIETLQKADIVVIGVRPQDDLKAVTADIAQNAKEKALIVSIVAGVTLAQFEDLLGKERAIARIIPNTLTDTGLGYSGVVINNQADKALTEKFVSGFGKCLFLEESLIDIFTGFGVCGPNYVYYFIEALVDAGVLAGLPRDIAWETTMENLVGSVKMLEISGKHPRQLLDINNSPAGVGMNSLFALNQSDFTAGLQKSVLAAVKRTTELGQKKD
>T0703 APC100815, , 272 residues	MEKLIVGKSLEHQLDTVIKELAPAGNISYAVLQFDDEEEPTLIAARGENTVHSSASLIKVLIMEYVFHLARTEQLDINDTVPLSRTPRVEGGGALQELVGKHSFTYLELCRLMMVLSDNIATNLLITVLGMENINARAEKLGVDEMELNRMMMDFNALAEGRDNHITAMSLARLYKHIFECRDRDVYGREMWNILGRQQFRDILPFYWGEGIRFHHKTGSLDRVEHDGGVIETFRGHFCFILLMSDIDNDRGKELGAQVGRIMKEFVEEALP
>T0704 APC102431, , 254 residues	MAAFKDHFTPVADAYRAFRPRYPRALFRWLGEVAPARGDALDCGCGSGQASLGLAEFFERVHAVDPGEAQIRQALRHPRVTYAVAPAEDTGLPPASVDVAIAAQAMHWFDLDRFWAELRRVARPGAVFAAVTYGLTRVDPEVDAVVDRLYHGLLARDWPPERVHVESGYRTLPFPFPELEAPPLEIEERWPMDAFLGYLGTWSAVTAHRRRTGADPLAEIAPALRAAWGTPERPLRVTWPIAIRAGRILPHAGG
>T0705 SP17384A, , 474 residues	MYKLIRNIGFAVVSLGLGMASCDEDYPKSHIEPYDTELLSIKILNAGANGDKVVEGTIDEAKKTINFPRLDVETDFSALSIEAELSEGAALQSEVMDYSMDAETNEKTQVLRIINHNRYKDYLMKVRKRVPVFGADFEKPTVYNFSGDNIYSDFATNYTRCASYDGEHVLVVSRPTTPNFHTPHLLKVSDLKRGEIKPIMLDVTGVKGGTYDYNMGALINGHVYLSSLSGGKVSPFKIYYWETPTSNPEVIANINVGNIPGAGNRHGDNASYNIDENGNGFIFFGDNAATEFLKVPISGHKTVDIGNIKVLPSKSDATMVTNVYRVGDTDQYLWSGIRVPVTLVDESLGEKYKSKIAGEAVAPKVVTFNEERYLLVCTAGQGAASKASIALEVYDLTKGETIEDALKKFDEGENHNPIYQFKLGGSGNGNALAQTDYYIEKDENGKDAKLCLFASRTQSGFVICEFPIKQEEMD
>T0706 APC102136, , 217 residues	RPVWYGEPVDIQPEHRDMMLVVDLSGSMAEEDMKTSNGDFVDRLTAVKQVVSDFIDQRKGDRLGLVLFGDHAYLQTPLTFDRNTVREQLDRTVLNLVGQRTAIGEGLGLATKTFIESNAPQRTIILLSDGANTAGVLEPLEAAQLAKDNHAKIYTVGIGAGEMQVRGFFGKQTVNTARDLDEDTLTKIATMTGGQYFRARNADELAEIYQTIDALEP
>T0707 GS13553A, , 366 residues	METNNRRDFLKKAALAGASALVAPSLFAADGEGRGELSPKIKAGDLESKLIVPKNNGLKITGTFLDEISHDIPHQNWGEKEWDLDFQHMKRIGIDTVIMIRSGYRKFMTYPSPYLLKKGCYMPSVDLVDMYLRLAEKYNMKFYFGLYDSGRYWDTGDLSWEIEDNKYVIDEVWKMYGEKYKSFGGWYISGEISRATKGAIDAFRAMGKQCKDISNGLPTFISPWIDGKKAIMGTGKLTREDAVSVQQHEKEWNEIFDGIHEVVDACAFQDGHIDYDELDAFFTVNKKLADKYGMQCWTNAESFDRDMPIRFLPIKFDKLRMKLEAAKRAGYDKAITFEFSHFMSPQSAYLQAGHLYDRYREYFEIK
>T0708 MI0968F, , 196 residues	MSVPTTMFRLTGRDYPPAKLSHASLIIIDAQKEYLSGPLKLSGMDEAVANIARLLDAARKSGRPIIHVRHLGTVGGRFDPQGPAGQFIPGLEPLEGEIVIEKRMPNAFKNTKLHETLQELGHLDLIVCGFMSHSSVSTTVRRAKDYGYRCTLVEDASATRDLAFKDGVIPAAQIHQCEMAVMADNFACVAPTASLI
>T0709 2.5F, , 33 residues	GCPRPRGDNPPLTCSQDSDCLAGCVCGPNGFCG
>T0710 Bd3460, Bdellovibrio bacteriovorus, 220 residues	MKKSYLLAALIFFLAGLLHGTAFAASGKSSKALNEAAEQGDLAKVKNLVQKNKIDLNAQDETGMTPLMNAAMGGNLDIVKFLLSKKVNLELKNNGGETALAFAVTNDAYDVAEELIKAGANVDIIVAGDEGDTLFMRAAQNNKKTAESILAKNKSLINKANTLGETALFAVARYGTPADIDFLIKKGADLKLKNKKGQTALDVAKEASNQDTAKALSKKK
>T0711 2.5D, , 33 residues	GCPQGRGDWAPTSCSQDSDCLAGCVCGPNGFCG
>T0712 GS13310A, , 223 residues	MRKAILFCLAITLLGTMLISFSACNGILSSLYDEPETAKDFGFITIDHANHSGTVRVDATQYTKWNYINLHTLQIDSAKVTAEGADDPDTWDLAIHRYDVKTNGGEVLETDYQSLSALKNAGSMPQGIFVADEWTTNKIAVDVSHMMEDNGYLIYAPSDFNPELSKWLNVDTSEMPPIYTPSNKVYLLRMKDDTMAAIRLVSYMNAAGIKGYMTFDYIYPYEP
>T0713 SP2600D, , 739 residues	MKNLFKRIITTILVLTMVMGFNVPFSATTVMAASITYNVSSTIKGVLTDDGVLTISGTGAMPDYTKIANIPWYKDRDRISEVRVNSGITSIGEANFNSCYNMTKVTVASTVTSIGDGAFADTKLQSYTGMERVKKFGDYVFQGTDLDDFEFPGATTEIGNYIFYNSSVKRIVIPKSVTTIKDGIGYKAENLEKIEVSSNNKNYVAENYVLYNKNKTILESYPAAKTGTEFTIPSTVKTVTAYGFSYGKNLKKITITSGVTTLGDGAFYGMKALDEIAIPKNVTSIGSFLLQNCTALKTLNFYAKVKTVPYLLCSGCSNLTKVVMDNSAIETLEPRVFMDCVKLSSVTLPTALKTIQVYAFKNCKALSTISYPKSITLIESGAFEGSSITKYPTWLSKGNNGDYGIFTKIKYKGTDKYSEAYKVLKIVNKERKSKGLSELKMDKDLLDVAMQRAAEVALYFSHTRPDGSSCFSATDKMEAENIAGGQSSADAVMTSWMNSAGHRANILTSYFKTIGIGCFTQGGTVFWVQCFGTDTPATVSRPADKNVVVTVTVDGDFLSKTKLRLDSSSYNLKIGNKKTVKLYVQNPEWASQNVLLDNSNFTFKSYNTKKATISATGKINAKTVGKYKIKATLKNATGTSVTKSGKITFPQPKIKVTVKKKKAIVAWKKLKAAKGYYVYRREAKGKKYTKWKKVKNIKKNTTVKYKDSKLKKGKTYQYKVVAYNRKNKGTSAIKKIVIK
>T0714 HR8578K, , 88 residues	PVHIVDPREHVFVHAITSECVMLACEVDREDAPVRWYKDGQEVEESDFVVLENEGPHRRLVLPATQPSDGGEFQCVAGDECAYFTVTI
>T0715 PROT_1178, Clostridium phytofermentan, 462 residues	MTVNEQLVQDIIKNVVASMQLTQTNKTELGVFDDMNQAIEAAKEAQLVVKKMSMDQREKIISAIRKKTIEHAETLARMAVEETGMGNVGHKILKHQLVAEKTPGTEDITTTAWSGDRGLTLVEMGPFGVIGAITPCTNPSETIICNTIGMLAGGNTVVFNPHPAAIKTSNFAVQLINEASLSAGGPVNIACSVRKPTLDSSKIMMSHQDIPLIAATGGPGVVTAVLQSGKRGIGAGAGNPPVLVDETADIRKAAEDIINGCTFDNNLPCIAEKEVVAIDAIANELMNYMVKEQGCYAITKEQQEKLTNLVITPKGLNRNCVGKDARTLLGMIGIDVPSNIRCIIFEGEKEHPLISEELMMPILGIVRAKSFDDAVEKAVWLEHGNRHSAHIHSKNVDRITTYAKAIDTAILVKNAPSYAAIGFGGEGFCTFTIASRTGEGLTSASTFTKRRRCVMSDSLCIR
>T0716 HR7907F, , 71 residues	PDSFGIRAKKTKEQLAELKVSYLKNQFPHDSEIIRLMKITGLTKGEIKKWFSDTRYNQRNSKSNQCLHLNN
>T0717 SP18049A, Staphylococcus aureus, 345 residues	MKKLIIRVVGVLFLVGFLIYLFYSPRLKFDVLENPNKGNKVNRSEQVNKSNNHAENPKPKEGVGTWVGKDIKVLTSKFGQADRVYPFRDGYKNYVFKDKNSYYIVSTKREEIVSVYATGEKVNVSPLKIGQHSAEIFNHTSINPEPSFKVDGKKYEFELSDEDLKTQTLIKYGDIYAQVYSDQQSKKVLSVRFLTKEMLADIEPYQLNSNSTSEEHNKRPVEQNPNQLISLYEVTNEMRKLKGLKPLKINSDLAHIASNNLYEATSNGSDSVEFTEDALRGQLDKNHVTYKTTAQNVGYAFNDVPTLIHSWMNSDIHRSRLLNSKYDEMGGDVMRDYYSLIFLEK
>T0718 HR8578C, , 100 residues	SRIFLVSVEEPLLVKLVSELTPLTVHEGDDATFRCEVSPPDADVTWLRNGAVVTPGPQVEMAQNGSSRILTLRGCQLGDAGTVTLRAGSTATSARLHVRE
>T0719 BT_4661, Bacteroides thetaiotamicron, 726 residues	MRSKLLNITSRLLGVLIVIAVTIVNSSCSDTETTDSTKFTIYYTGMTDIGPSMTGVISSPTYKGGTPYDFAITRITLDGEPFSDSIFAIDSETGKITLNSTSNTPVGLYKLSVACYSNNNRYEYTDIVEINMMKPVPDGIKTDPEKLQVEYADIIDTESSNELPTSQIRTEGNHISISNYTIASAMWNGVAVESPEDYFAVSDKGEISIIKGNQNIQPGKYILSFKLTTAATGEDPEKGIFENALEINVTSRPLSLIYTPDEGKIEEEGERSPETTFQSNIPALKGSAEGLVYSISSVSPNTDKITIDPTTGVLSVAAHHGFKDGEKYQISVKAINEFSPEGVVFENVFTLNTVEFIEPIANFGYADVNDVQAVEIDINKNENFKGDEVKYEFVNLPTDLQGELALDLDGNIAIKKGNKIPVGQYTVQVMATNTKGSETATFTLTITANPNYFTYFRYGNNLGLTPIENYADQFRIEAGGKLNSVKPVPTATDAKDGLSSLKWEVELKHNPNNTKATINESTGQITITGLKQGQCGMVMVTATAGEGKTAVSVKQPVFFHFSMISDSNVQLEYTPFVFQVNPARGGESIAPSLGAGIDKSTFRLDYRRDFFYYNIAGPDSHISGALAQKVDNFLSEMWNSYDATAGTSRKPMSYFENTTNLSKALGYIDQTDFKVHINPNLWRNKDGYANGAMIGQITYDVTGKDPQAATSGARVSPIFIWFDTKF
>T0720 SSO0001, , 202 residues	MITEFLLKKKLEEHLSHVKEENTIYVTDLVRCPRRVRYESEYKELAISQVYAPSAILGDILHLGLESVLKGNFNAETEVETLREINVGGKVYKIKGRADAIIRNDNGKSIVIEIKTSRSDKGLPLIHHKMQLQIYLWLFSAEKGILVYITPDRIAEYEINEPLDEATIVRLAEDTIMLQNSPRFNWECKYCIFSVICPAKLT
>T0721 THRDXN_REDUCT, Bacillus anthracis, 301 residues	MKYIDCAVIGAGPAGLNASLVLGRARKQIALFDNNTNRNRVTQNSHGFITRDGIKPEEFKEIGLNEVMKYPSVHYYEKTVVMITKQSTGLFEIVTKDHTKYLAERVLLATGMQEEFPSIPNVREYYGKSLFSCPYCDGWELKDQPLIIISENEDHTLHMTKLVYNWSTDLVIATNGNELSQTIMDELSNKNIPVITESIRTLQGEGGYLKKVEFHSGLRIERAGGFIVPTFFRPNQFIEQLGCELQSNGTFVIDDFGRTSEKNIYLAGETTTQGPSSLIIAASQGNKAAIAINSDITDERF
>T0722 RPRD1B, , 152 residues	MHHHHHHSSGRENLYFQGAGPLLTEELIKALQDLENAASGDATVRQKIASLPQEVQDVSLLEKITDKEAAERLSKTVDEACLLLAEYNGRLAAELEDRRQLARMLVEYTQNQKDVLSEKEKKLEEYKQKLARVTQVRKELKSHIQSLPDLSL
>T0723 4FLB, , 132 residues	GSAGALESSLDRKFQSVTNTMESIQGLSSWCIENKKHHSTIVYHWMKWLRRSAYPHRLNLFYLANDVIQNCKRKNAIIFRESFADVLPEAAALVKDPSVSKSVERIFKIWEDRNVYPEEMIVALREALSTTF
>T0724 GS13689A, Bacteroides vulgatus, 265 residues	MAKNVLKAWLVDNTVTTDDKTDKIFQLETTRSIDKEIILDRMVAKNPGVRRETMALGIELMEEVVAEALMNGESVNTGLFRGVAQFRGVAKQNAWDAATNSIYVSLTQGKALREAIKDTRVDVLGERPTKFYIGSGQDATTRATDFSATAGRNFTLFGKNLTVAGTDPSVGVTLASAATGTVTKIDNDMIVLNEPSRLIILLPASLEDGEYMLTVTTQYRGGGGALLKTPRSTSHTIYIGGAPETGGSTGPPGDSDGDLNENPLG
>T0725 NP_689505, Homo sapiens, 370 residues	RVRRDVVHSTLRLIIDCSFDHLMVLKDIKKLHKQIQRCYAENRRALHPVQFYLTSHGGQLKKNMDENDKGWVNRVRRDVVHSTLRLIIDCSFDHLMVLKDIKKLHKQIQRCYAENRRALHPVQFYLTSHGGQLKKNMDENDKGWVNWKDIHIKPEHYSELIKKEDLIYLTSDSPNILKELDESKAYVIGGLVDHNHHKGLTYKQASDYGINHAQLPLGNFVKMNSRKVLAVNHVFEIILEYLETRDWQEAFFTILPQRWKDIHIKPEHYSELIKKEDLIYLTSDSPNILKELDESKAYVIGGLVDHNHHKGLTYKQASDYGINHAQLPLGNFVKMNSRKVLAVNHVFEIILEYLETRDWQEAFFTILPQR
>T0726 IlR60, Idiomarina loihiensis, 597 residues	MIAYDITPIDLHGHLFNVSLTIEQTNDEQELWLPNWIPGSYLIRDFSKHIIGLHAESNGLSLPVKQISKNRWQLARSKHPVTVHYQVYAWDLSVRSAYLDQFQGFFNNTSLCLAVEGQTDLPCELHLHAPPEAPLWKVATGMPRKSGQPHSWGCFRADNYDALIDYPFLIGDLTIEEFIAHGIKHSLVLSGRHYADTSRITADLAKICETQISLFEEAPFQSYTFLTMVVGNGFGGLEHRNSTALLCSRKDLISAHQYEMNDNYQTFLSLCCHEYFHSWNIKTLKPKAFLPYQLEKESYTEQLWFYEGMTSYFDDYLLHTSGIIDEKRYLKLLGDTLSRVERGAGQYQQSVTESSFLAWTKFYQQNENAPNSIVSYYAKGALIALSLDLMLRLQSDHKLTLARVMKELWHEFGKTSIGTADDTVINWLNQYPGIDISDFLKDALYNKESLSLVELLQNFGVMVQKQVPVDDNSVGGKASEQPARVNFGAKYKASPQGLDVLNVYHDESAYHAGLSAGDKIIAIDHLQATEQSVKRILERYIPGDTVTIHAFRRDELMTLELTWQEPAKSSYVLSVEQPDKLKGWLTPSGLEHHHHHH
>T0727 HR2876B, Homo sapiens, 93 residues	YMFIQTQDTPNPNSLKFIPGKPVLETRTMDFPTPAAAFRSPLARQLFRIEGVKSVFFGPDFITVTKENEELDWNLLKPDIYATIMDFFASGLP
>T0728 GS13780A, , 154 residues	MKKLVIILISIISMVSLTACKKSNESKYNNLNNKESGQTTIEMDLDKNYDTSDPFVNARLFCVSNDIDVLDTEISFKMDGDSGIVEIKDNKTDETLWSNTWHGSVDNDTFTISLSNIQKEKEYAICFTGIKINHAVVKVTFESNLVKEKEKPSK
>T0729 HR8578D, , 96 residues	VAEPPVRVVAPEAAQTRVRSTPGGDLELVVHLSGPGGPVRWYKDGERLASQGRVQLEQAGARQVLRVQGARSGDAGEYLCDAPQDSRIFLVSVEEP
>T0730 GS13882B, Bacteroides fragilis, 167 residues	MKTKNYLSIISILFFSFLFVSCSKEDEGDTIKPVIDLLEPEEGAILRIGSSHGVHFEMNLHDNEAIASYKINIHNNFDGHSHTRASEAGITKPFTFERTYTDKAGQKDAYVHNHDIKIPADATPGNYHLMVYCLDQSGNETYVVRNIVLSVEGGEEGEHHHDEHHHD
>T0731 HR3520O, , 79 residues	KHSSRLEAHLTRDELRAKALHIPFPVEKIINLPVVDFNEMMSKEQFNEAQLALIRDIRRRGKNKVAAQNCRKRKLENIV
>T0732 Dbr1, Entamoeba histolytica, 354 residues	MATEQIQHIAIVGCVHGKYREMYRQLSEYEKSTGKEISFVICTGDMQTLRYEADLVYLKVPPKYKQMGDFHLYYEGKEKAPYLTLFIGGNHESSNVLLHLYNGGFVCFNMYYLGVCSCININGLRIVGVSGIYKSFDEKKPYTYPPSPNDVVSLFHTRNYVIQMLSNLSQSSQIDISLSHDWPQGIVMKGNYKQLYRFQPGFKKDGASLGSPINKVILNTLKPKYWISGHMHCEYHAEEGPTHFIALGKIGYKNAISYLDLPLKQKTDLEYDKDWVCNLIMTWPAFSNKAQFPDLSYSISELLSKRTKELDKKIIELWEKYIGLKIIYDSDTFDIQFTSRRFYIEKIYNELNIN
>T0733 B5Y097, , 390 residues	MSARLNIGLIGSGFMGQAHADAYRRAAMFYPDLPKRPHLYALADQDQALAERHAAKLGAEKAYGDWRELVNDPQVDVVDITSPNHLHYTMAMAAIAAGKHVYCEKPLAVNEQQAQEMAQAARRAGVKTMVAFNNIKTPAALLAKQIIARGDIGEPVRFRGTFDQGFYNDPNLPWSWRCSKTLGGSGALGDLGAHTLSVAQFLLGGIREVTASAQTCLRQRPVPQRDAGYASRVAADAEWREVENDDQVQCLVNFDSGAAGVIEASRIAAGRIFGVFWEVSGTEGTLYMDGERFNELQVYRFNDDKHDRGFKTLYAGSQIPAYAGFFGFDFGGGGLGYFDVKVIEVHDLVQGICGDDDCYPNFEFGLQNQRVLSAIEASMVSRRWVNVVKD
>T0734 OrfY, Thermoproteus tenax Kra 1, 216 residues	MADLDSKAKSPFVFKSAYYLSLYTKRRARNLRQLAEGIRAADPGVIFHHVFHVVFAKHLLHPYYTNDFARWVGEELNDDDLAIELSSISGAEPATVEDVRRELLAVLEPRADERAARREFVFVSMVPIVYEVGLKAETLAEFLDAVAAAPPESVAYHFVTARVLYGNGRNDFSRWLVEEFGLTSAADALSRIDPLIYNDERQLKSEVVRTLERALL
>T0735 SP19411A, Legionella pneumophila, 349 residues	MTNDHYVSKKKMFAVVFCVFAPNEVLLANDTAVGGEGSLPIPVSQPHIKMVSELIRISGKNLNEPQMNGSWHYNCNFTFKNTLNKEVTISMAFPFPINDGNSEIALPAGQQTNVGQALVYDFLVTVNDKQVSAQRGNIAPDQNKGLYYEDAYFWKTTFPPLATVNIHHDYSTGATYDVMGYHWVRYVLKTGALWQDSSIGHTRLEVIPNTPTRLCSEIDQKADYLNPTPSGMSISGSRADRKYIWDLRHFQPQADLSLCLFTGISYVRYKVIYPWLNSDDALSKLARLSNKELRFLRNTIYAQYGRQFQSPDLQEYFSKKWWYVPNPDYSDRMLNEEDKKLLSMINQAK
>T0736 BA11652C, , 168 residues	MTLEARIEALEKEIQRLNDIEAIKQLKAKYFRCLDGKLWDELETTLSPNIETSYSDGKLVFHSPKEVTEYLAAAMPKEEISMHMGHTPEITIDSENTATGRWYLEDNLIFTDGKYKNVGINGGAFYTDKYEKIDGQWYIKETGYVRIFEEHFMRDPKIHITSNMHKEK
>T0737 R596, , 292 residues	MSLSKQVVPTHRVEIAPNSESTCKMDHSNYQHNGLITKIWGTAGWTFNHAVTFGYPLNPTSDDKRRYKNYFISLGDVLPCRLCRESYKKFITTGKTALTNEVLRNRHTLTKWFYDVHNAVNNKLEVDYGLSYEDVVNKYESFRAKCGKPVPTVKGCVTPLDHKAFSFKKLYYMDAPIVSLDKVENFVRIARMRGISDKYFCFLELATVLNGDFNELKKQSSWEYRNKYCQKKIRHMRENAIPSIEEQGYWKGTPTIDELKLLLFLCSNLNRTEVNDAINNVERLESTHYIEN
>T0738 BA0019A, , 249 residues	MNLVQDKVTIITGGTRGIGFAAAKIFIDNGAKVSIFGETQEEVDTALAQLKELYPEEEVLGFAPDLTSRDAVMAAVGQVAQKYGRLDVMINNAGITSNNVFSRVSEEEFKHIMDINVTGVFNGAWCAYQCMKDAKKGVIINTASVTGIFGSLSGVGYPASKASVIGLTHGLGREIIRKNIRVVGVAPGVVNTDMTNGNPPEIMEGYLKALPMKRMLEPEEIANVYLFLASDLASGITATTVSVDGAYRP
>T0739 tailspike, Escherichia phage vB_EcoM_CBA120, 770 residues	MNEMFSQGGKGSTGILTNKQAVARHFGVKQSEVVYFSVGVDLGGYKVIYDKETQRAYSLPVGIASGTTAVSLSTAAVLVHSAGSVDLGSLAVSREEYVTLPGSFDSGSTLNVKNELLTYTDGKYRWDGILPKTVAPGSTPASTGGVGLGAWISVGDASLRTQLANGDGSLIGIHPQGTLNNVLTVRTPEQYNAVGDGIADDTSKLKEMLSDINNVPETLPDAAAVNSYMEQVAVKIDLTKLYRFTETLYIPPGVSIEIPTSNFFTRECKQGLFYDPVDKNTAAISLMVYRKQPDGSYKLNKDVDYYPTGLDIDNGDAITCARKIDINNLNLITAPGVKVGVKWIGGAGCTTKGLSIGENTGSDITTARLPRVGLLQSASWGSIHENLRILYKTQGAVFIDSNGGAAVNNAYISRLGNTNGELEQAVYKPAGFTEVGDVAVTQFAGSEVKFNSPIIEQASFDFVHAGRDTDSYGLFMVDKPHIESSGGKKKHSFYLINTSSNVTLSGVGLSGQDPDLDSMYFLKNCPETARNVVRGQMPISGVKLVRGTGNYPTLVLDCTNMGSQFQFGEVGDIFYIKDVVGVKADTLYIDPVNGNNYNWGTNGTKPIRELTNIAKICQLFRCKSVYLNAGESVITSNTELPMVVFEGPGSLKANSGSSFLIKAGGTLSLIGLSGISTDGGHMFRVSTVEKVNIHTNCSVNAGAAYVVLSEVQGNIEYRQLFYSVNCSKYIGATAGQTIAGIMVKTATRPTGIDAAPVDGNVSLTYKIIES
>T0740 EhV298 , Emiliania huxleyi virus 86, 165 residues	MATVGQKRTRAEVGYPLSWLKDKHPIEEPDLEYSLKWFKKHEYDLETSKLQEVSEKVGDAYDTLCETTQEVVKAVGYSVISDIQGEHVVDRIDWRHACDKCIDFGELIDEIYYELTIAMINTKLENADIDPDMVEEMASDLARDIQSSEMSEIDYNRRIQEMIDA
>T0741 Q6MLV0, , 181 residues	MEHGLSGKFIYVKHLDIKTKGVFMKLMIAMLMMLPTLATAATEIVYNSSSNPYIPARGYVTAQQICLNANKDSFKIFVAQHTVETCDSVKTDYSDSTRPKKVCVGRKMVTVPATTKIVSAFTKKEVCQKWNRNDSAYPRCVSSVMKDTMYSTSYTQYKYEQADWRRERPVSSVNKYIETCK
>T0742 SP16885A, , 312 residues	MPYASNKKTNRMKLNRRVTIITRFSGIMFSLLLLGGLAACSDDNNGSDTPEPEPSTYPTTPFSKIELKEVIESDAQPVTATHTYLYNSAGRLTGYTGKQSFTAGDELFEIENTTTVEYKDHQAVITDEAGTVSTYTLNDKGYATTCTSQDMAGNTRTYTFSYLINTEDKYYLENITEKLDDGKEYSFITIDYSNFRALRIQQKVDTFEHNSTATTPSGNEIANISEIPSLFITDMYPLSMHAVAIYGKILGEPANYLITQLIPDSNGESEETTTYTYTLDNRGIVTSCHAVVRHIRNGYEQDYTRTVNYTIE
>T0743 SP17944A, Ruminococcus gnavus, 149 residues	MKKNMKKLAVGFGVFVMAVGSLMGCSSLGSGGNEQGEILKELPEGFDKETVRKQAMEDIEIAQSKDYESWKSRFTKDLQSSLTEESYDSYLKILEKQGEFKEFGKCTYLGQIKDNKKYGGVIIVVKYEEGNVNYSLAYDEDMNLVSFTM
>T0744 A0R2V4_MYCS2 , , 329 residues	MSDTRLDVATLANAVQLAARAPSLHNTQPWRLIAEDGELKLFLDPSRVVRSTDRSSREAVMSCGVLLDHLRVALAAAGWDTEVQRFPNPNDRDHLATLSFRPLQFVTEGHRKRADAILARRTDRLPMSAYVDWDAFETLLRARLGDGPVHMDTLGEDVREEVAEAAALTESLRLYDAAYHSELAWWTTPFATEDGIPQTALISAEESERVAVSRDFPVAPHSSRRPALNNDAATIVVLSTDGYSREDALDAGEGLSKVLLECTMSGLATCPVTHVTELHTSRDIIGRLIVRDACPQVLVRIGLAPALDEVPPPTPRRPVDAFLEVRPRS
>T0745 NP_689505, , 185 residues	RVRRDVVHSTLRLIIDCSFDHLMVLKDIKKLHKQIQRCYAENRRALHPVQFYLTSHGGQLKKNMDENDKGWVNWKDIHIKPEHYSELIKKEDLIYLTSDSPNILKELDESKAYVIGGLVDHNHHKGLTYKQASDYGINHAQLPLGNFVKMNSRKVLAVNHVFEIILEYLETRDWQEAFFTILPQR
>T0746 SP17257A, , 367 residues	MKKIKFLAVALAAFTMFSCTNDEVENLGNNVPGEQAVLTIKLKGDGDNQAQSRAAGPATDTEDAVINNYLVFLFREGGALDCAPYEGSSNAAATITTGTTAAKKAYVVANTGALAGGLFATVKTETDLLAVTGSLMDNTDNASTQTKTNLWMSGESEVKFNGGTNAQVTVSLSFVAAKIQLIVKDNRKNMTGGTITITDDAAVLLFAGKKGRFFGSAAEKVTQNEFYTGFNQYTGAFDSGVTTSTALSDAVSPGDFTINAGSTVFNHFYTFGNDGTTQPTILAIKSTKTVGGTSSPIFYPILFTNTDARHTIEPGKSYTVTVTLNGDVAAGGGGGTTDPEEPVVSSSIEVTVTAAQWVTQPVDKEFN
>T0747 SP16708A, , 121 residues	MKKFELVLLVMLLIHSFSVMIEAKQHVKTKSDWVIQRTPVDPEWLKVYVDDESKRLCLNFKDSFAPITVEVKDIEKQIVFQSIIFPVAAGEYTLYLGDLSLGQYELYMYNASVKVVGNFTL
>T0748  HR8574A, , 59 residues	SGARCRTLYPFSGERHGQGLRFAAGELITLLQVPDGGWWEGEKEDGLRGWFPASYVQLL
>T0749 SP13905B, Bacteroides uniformis, 449 residues	MFKIGIMKNIFLFFLFLGVCSCSVNAINPPSGVTEKQLSDDELMTLVQKQTFRYFWDFAHPESGLAHERSNGGAETATIGGSGFGVMAIIVGIERGFVTREQGAERMLKIVRFLSDKNTDSYHGMWAHWMNGKTGKTIPFSRKDDGADIVESAFMFEGLLAAHQYFTKDNPTENRIRGIINNLWRQAEWNFFTQGQDVMYWHWSPNNGWAMNHQIKGHNECHIVYILGASSPTYPIAESVYHKGWANANTFLNGREYYGIKLPLGNNHGKGGPLFFTHYSYMGLDPRGLKDRYADYEEQMKAHTLINRAYCIDNPKGYKGYGEKCWGLTASDGDKGYSAHSPGNDRGVITPTAALSSIPYAPEYSLEAMRYFYEELGDRLWGEYGFKDAFNLTENWFAPSYLAIDQGPIIVMIENYRTGLIWKLFMSHPDVQKGLRRLGFTSPYLNKVD
>T0750 APC103766, , 188 residues	MRILMLGNSLTTANHMPDMLAELLTAEVRVHARGGARLAEHLNPKTRNGALTQAALANEAWDFVVMQEMSHGPATSPTAYARSVASLSEAAKAAGAQPVIYGTWPYRAGCAKLVKLGMSHDDMSLRMAEAFAQAAADSGALLADVAAPFRAGSADELYAADGVHPSPAGSRLAALVLAETMGKGIRPW
>T0751 HT8470A, , 111 residues	QMLLNQLREITGIQDPSFLHEALKASNGDITQAVSLLTDERVKEPSQDTVATEPSEVEGSAANKEVLAKVIDLTHDNKDDLQAAIALSLLESPKIQADGRDLNRMHEATSA
>T0752 APC103577, , 156 residues	MDAETDRAEIIELFGRYADIADLKEFTDLPRRVHTDPLTIDFESVTGMPPMTVPLSDYGAALRASFGAFSATHHAITGHVVTIDSDRATIHAHVRAEHWLPAEVAGDGPDRWLVVGFYDNEAVRTADGWRLSSVKLTASYQENAHLARAAAAGQAG
>T0753 PC07372D, , 109 residues	MLLSTDIWVAALIRRAELGGAFATVARKGDARAGAVLVKAVDRREGTARLFSEATRGDGERFWMQPVRSTFEPDLDAYAERAARIDPDIWVVEIEDRDGRHFLTEPVES
>T0754 HR6512A, , 80 residues	SEDGSYGTDVTRCICGFTHDDGYMICCDKCSVWQHIDCMGIDRQHIPDTYLCERCQPRNLDKERAVLLQRRKRENMSDGD
>T0755 SP1264D, , 264 residues	ASKQSASGTIEVISRENGSGTRGAFTEITGILKKDGDKKIDNTAKTAVIQNSTEGVLSAVQGNANAIGYISLGSLTKSVKALEIDGVKASRDTVLDGEYPLQRPFNIVWSSNLSKLGQDFISFIHSKQGQQVVTDNKFIEAKTETTEYTSQHLSGKLSVVGSTSVSSLMEKLAEAYKKENPEVTIDITSNGSSAGITAVKEKTADIGMVSRELTPEEGKSLTHDAIALDGIAVVVNNDNKASQVSMAELADVFSGKLTTWDKIK
>T0756 APC103578, , 179 residues	METTGQMPATSSLVDLLHHPLRWRITQLLIGRSLTTRELAELLPDVATTTLYRQVGILVKAGVLMVTAEHQVRGAVERTYTLNTQAGDADHDGVDADRLRTMFTVFVAGVGGHLDQYLEREQIDPLADGIAFRQTALNLSDEELAEFLTAFGEFLAPYVAHSPAPDRTRRVLSTILIPD
>T0757 APC103790, , 247 residues	MAFIQTDTFTLRGYECDAFGRMSIPALMNLMQESANRNAIDYGIGIADLAQKGVGWMLMRFCLRIHQYPRYGDTIQLMTYPTTVDKYFIHRDFRVLATDGTLLADARSTWLVFSMEKRSMVPLPDFIRQLSPPANVDPLPALPLKPDFQTASFATAASKSVQVGWLNIDQNQHVNNVAYVQWLLEGVDSEIVQTREIAEIDLVYRTESHWHDWLSVQSVTETDNSVLHRISQTESGKDVLLARSRWR
>T0758 APC103749, , 388 residues	MYDGLSRDEQRLLNHVREYGEKYFTPASISKWRKDQGLPDEVVKAFVDLDFNGFGVIHRRNHRTYDLFAQVLVIEELSRISGACLPFQNDLLQLQILEAFASSAQTSPFRTEYQDTGRLSYALAISEPEAGSDTRSMRTHVTREGDTLVMNGTKMFVNNGEYAPALLVSAYDKTGDDGEPEFSFWMVPRSAAGIYAYPEQKIGQSMLPFATVRFDNVEVKESWRLKGSSKGFSQLYSLLEYGRVFTCAAALGEAQAAMEDAVAWARGREAFGQRIADLQQVQMKLTEMEVKLTNMRNLVYGAAREYDRGEHKRLSVALMKYYVPKAATEVASDAMQILGGRGYIQENRVSSIWQDCRGYQFADGTDEVMVVIAAPLILEQYKASKNNR
>T0759 HR9083A, Human, 109 residues	MGHHHHHHSHMVVIHPDPGRELSPEEAHRAGLIDWNMFVKLRSQECDWEEISVKGPNGESSVIHDRKSGKKFSIEEALQSGRLTPAHYDRYVNKDMSIQELAVLVSGQK
>T0760 SP13419B - BACCAC_02139, Bacteroides caccae ATCC 43185, 242 residues	MYMKKLKFITLTLAIIITLPMLQSCLDDNDHQSRSLVISTINQISEDSKEFYFTLDNGKTMFPSNSQAWGGEKFENGQRAFVIFNELEQPVNGYDYNIQVRDITKVLTKEIVTMDDEENTEEKIGDDKINATYMWISKDKKYLTIEFQYYSTHSEDKKHFLNLVINNKEADSAAENEDNTDDEYINLEFRHNSERDSPDHLGEGYVSFKLDKIEEQIEGKKGLNIRVRTLYDGIKNYKVQFP
>T0761 SP17865A - CLOLEP_02462, Clostridium leptum DSM 753, 285 residues	MMKLARKSVPFIIAVALLAACLLAVGLSPLVLPDYKGTIEEREQPQNFNLLYLNSGEELNLYPWNLYTGQEQELFEEEIVSFAANSVRILGGGSWTDEELYPLIKFRYSGQDLRFLKDMALTEKDGRRYLVNMALDPNGLCYFSYVNQDEREATADEMDQALGKLQEDWEKFLSDPLPADSEVDLYEEKPSGSYQLDDGELKTDNAFYMFFMRCQMLSDQMRKEQYSDYIGDNLYTIWELVLKSEFTSLSYDNHIYAMYSNDGGTSMVLIYSPIEERFVGFSLKY
>T0762 SP17422O, Streptococcus mutans UA159, 280 residues	MKLKKILGLLGLALAAAFVLTACGQKNDKNTLTVGVMTMTDSDKERWDKIEELLKKENIKLKFKEFTDYSQPNKALKNGEIDINSFQHYNFLNNWNKENKGDLVTVAETYISPINLFSGTENGKAKYSSAKEIPNGGQIAIPNDATNESRALYVLQDAGLIKLNVSGDELATVKNIKSNPKNLDIKEVDASQTARNLASVDAAVVNNSYAVPAKIDFKTSLYKEKVNEGSKQWINIIAAQKNWKKSKKAAAIKKLIKAYHTDAVKKVIKKTAKGVDEPVW
>T0763 SP18434A - CLOSPO_01618, Clostridium sporogenes ATCC 15579, 163 residues	MKKTNKIIFIVFIVIFIGLSYRHFTNTDKARMEISSLSSIDVFKFNSFSKFSNDKIGVIYDEEKLSKFKVIMNSLDTSEGIKKIEVPKDANIESFKYSYHIQPNLKYVEDNNVYDGYFLLYILVGDSEGKSYIIFSGTELSYVLDKNNTNILKEIFLNVKKQQ
>T0764 SP18347A - BDI_1566, Parabacteroides distasonis ATCC 8503, 341 residues	MRPVFILGIILLLVGCKQRDERVLMVDEQGSFAVGGTVLVDSLGHTFHGDHAYVFYQKPVGARKYPLVFAHGVGQFSKTWETTPDGREGFQNIFLRRRFCVYLVDQPRRGNAGRGTESVTISPAFDEEVWFNRFRVGIWPDYFEGVQFKRDKETLDQYFRQMTPTIGTTDFEVYSDAYAALFDKIGPGVFITHSQGGPVGWNTLLKTRNIKAIASYEPGGAVPFPEGQLPEEAKFITLSKKMEGIEVPMSVFMEYTKVPIVIYYGDNLPETDERPELYEWTRRLRLMKIWAKMLNDQGGDVTVIHLPEVGLHGNTHFPMSDLNNIEVADLLSEWLHTKALD
>T0765 SP18632A - KPN_03524, Klebsiella pneumoniae subsp. pneumo, 128 residues	MMVMKRPSLRQFSWLLGGSLLLGALFWLWLAVQQQEATLAIRPVGQGIGMPDGFSVWHHLDANGIRFKSITPQKDGLLIKFDSTAQGAAAKEVLGRALPHGYIIALLEDDNSPTAWLSRLRDAPHRLG
>T0766 SP13297C - BACUNI_04292, Bacteroides uniformis ATCC 8492, 130 residues	MKKRVIFLLTGLFIWTSVLLAQNVPEGVIGAFKEGNSQELNKYLGDKVDLIIQNKSTHADKRTAEGTMAAFFSNHKVGSFNVNHQGKRDESGFVIGILMTANGNFRVNCFFRKVQNKYVIHQIRIDKTDE
>T0767 SP17984B - SAV1486, Staphylococcus aureus subsp. aureus Mu50, 318 residues	MLKKAKLILIAVLVLSGCSTIENESKKDRNTETNTETKSVPEEMEASKYVGQGFQPPAEKDAIEFSKKHKDKIAKRGEQFFMDNFGLKVKATNVVGSGDGVEVFVHCDDHDIVFNASIPFDKSIIESDSSLRSEDKGDDMSTLVGTVLSGFEYRAHKEELDNLTEVLKEYKSKYKYTGYTENAIMKTQNSGFRNEYYYLTAIPYTLDEYKRYFQPLIKEDDKSFRDGMRNSKKQLKDKSRPYVVTTLFSTKDNFTKDNTIDEMIDFSEVLKKKKNIPHDLNVSLQISNKYINTKRPNYSKKEVIEVGVFNHEKANTND
>T0768 EL13177G - BACCAP_00569, Bacteroides capillosus ATCC 29799, 170 residues	MKKRALSLLLALCLCLSLMPAASASVVESTVQVGPYTFEIWFDGTATLTRYDESLAGSTYADIPASVTDENGQEYPVTVIGEKAFEETNITGVTVPDSVISIGRLAFAYCNSLSDVKLSENLIYINELAFASCDALKEITIPASVEKMDNPFRWSNALDTVYMEGMVAPE
>T0769 OR414, , 112 residues	MLTVEVEVKITADDENKAEEIVKRVIDEVEREVQKQYPNATITRTLTRDDGTVELRIKVKADTEEKAKSIIKLIEERIEEELRKRDPNATITRTVRTEVGSSWSLEHHHHHH
>T0770 GS13194A - BT2259, Bacteroides thetaiotaomicron VPI-5482, 488 residues	MIMKKKILAYALSALTCGLFTSCSDWLDINHDPNTAEKVDPGYLFNYVAVNWAGTRTGGDFYIPLSMSSQCQVDGGLDYGGWDESVYTISPYSTGNTWKHYYSVGGNNLMLAIKNAEEADPVNHNAIAQCKILLAEHMYEATMLWGDIPFTESWNGTIKYPKFDSQESVLNGVLSLLDEALQIMDLNDANAIDEYDIYYKGDMNKWMTLAKSLKFRTLMVMVDKDPSKATAIGTLLQAGGMVSSASDNLVFPYSAEPGNQNPKYELIELVGGTQILFFASNYMLKPMQERNDPRIPCYFEPGADGVYRGLGNREPAVTDDKDNMLSSVVSSYLFRKDAPELIYSCQEQLLLEAEAYARGLGVAQNLSKANELYKKGIREACAFYGVAEADIDTYVTGLPELTALTQEKALYEIHMQQWIDLMDRPFEEFVQWRRSGTAGNEVPTLQVPEDATSKELIRRWEYSPEEMTANINAPKESPKIWEKLWFDL
>T0771 SP17061B - BACUNI_01052, Bacteroides uniformis ATCC 8492, 204 residues	MKRLLLITLLIGYIYPCVAQDKPIRTEESLEGTVIYKKTTTFEVDGYTYQCDVDDGSQFVTLYNKENKLTYEKIVYKDTGKTYIGSWSSNVIEYDRFMSQQADFIVDQAFTKAMADEIGKTELMITMLLSPNTGEVMEVNFNFFTFEPYAKVPLHVYREIEVKLKEQIHFKPIEEGKQLNYIMLAWMQKPQGKLPPLPPPGSLM
>T0772 GS13654A, , 265 residues	MNKRLLTVAAFALAGCVTVVAQDKKKEFKMPTGYAGITHEMSEFYEPVPPVVTPGTDLKGGGFTAPSDAIVLFDGKDLSAWESVKGGAAEWDVHDGVFTVNKKKGDIQTKQKFNDFQMHIEWQVPTNITGESQSRGNSGIFLQGMYEVQVLDCYNNPTYVNGQTGSIYKQSIPLANAMRKPGEWNVYDIIYTAPTFKEDGSYRTHPTVTVIQNGVVLQNHTTILGTTEWIGFPQVKKHGAGPIILQSHGDPSEPISFRNIWIREL
>T0773 OR358, , 77 residues	MVDLKIDVSDDEEAEKIIREIREQWPKATVTRTNGDIKLDAQTEKEAEKMEKAVKKVKPNATIRKTGGSLEHHHHHH
>T0774 GS13876A - BVU_2522, Bacteroides vulgatus ATCC 8482, 379 residues	MEVKSLLMVMATLTIAGCSQNEMTEMNPDTNRTIGLDVYTEVQTRGTETTTSTLKANAGFGIFAYQTSSAGWNSEKGNTTPNFMYNEHATWTSDSWGYTNLRFWPIDDKKITFFAYAPYESKPEVGTDQKITLSGQNAKGAPTITFEVKTSNNWKDMIDLVTDCHTAIQDQTNESNKGTVQFKFSHVLTQIANIKVKPDVNLGTDTKIFVTGLKLDPGSTTLYNKAVYKFDNDTWEAISPDASYFSTEQDLSDFLNKTTTDQWGYNKSSINVSDDQNATALFSDTEALYFIPVNNKNGTTNAGDLKLKINYDIVTKVTDTSNLTSTITNKEVSLPKNTFKKGTKHTYVLTIKMNAIKITVEDNMEGWTDDSDSDINVEK
>T0775 Long tail fibre protein gp34, Bacteriophage T4, 390 residues	DIAQTVNGSLTLTQQTNLSAPLVSSSTGEFGGSLAANRTFTIRNTGAPTSIVFEKGPASGANPAQSMSIRVWGNQFGGGSDTTRSTVFEVGDDTSHHFYSQRNKDGNIAFNINGTVMPININASGLMNVNGTATFGRSVTANGEFISKSANAFRAINGDYGFFIRNDASNTYFLLTAAGDQTGGFNGLRPLLINNQSGQITIGEGLIIAKGVTINSGGLTVNSRIRSQGTKTSDLYTRAPTSDTVGFWSIDINDSATYNQFPGYFKMVEKTNEVTGLPYLERGEEVKSPGTLTQFGNTLDSLYQDWITYPTTPEARTTRWTRTWQKTKNSWSSFVQVFDGGNPPQPSDIGALPSDNATMGNLTIRDFLRIGNVRIVPDPVNKTVKFEWVE
>T0776 SP16962B - PARMER_00689, Parabacteroides merdae ATCC 43184, 256 residues	MKNSRRDFLKKGALAGFSALMIPEIAKAAVKENTSVHAPKINLKKDCVILFQGDSITDCGRDRNSNRCNTMEQFGSGYVLFTATQLLEGKAALQPKIYNRGISGNKVYQLRERWEIDCLAFQPDVLSILIGVNDYWHTLTHGYKGTVETYENDLRALLKYTKEKLPNTQIVLCEPFTLRDGAAIEDSKWYPMFDEFRKSARKLSEEFNTIFVPFQSGFDAAVKLAPARYWSNDGVHPDLPGRQLMANMWMEATGLK
>T0777 MLP, platypus, 366 residues	MALSLCVLFTLASVVSGHVAHPSLGRGDGFPFLWDNAASTLDQLNGTDTTIILNGFNYLDRLSMFKTVLEGTRKYFDSFAPNNTANIYWGFTIYLNWILATGRSADPTGHTTCGLAHGDPMCLAEESWWNCIKYNPAAIAFFAAKKAGIFGDVTKTIVLAKPKEANSPYCSSEEECQAAYPDVMATYLDYFEYLMSLEKTGESIDMDKAQQLLWKAHVTSMENSIAVCKPRLKNYNIIERQLDRDYLISLLYFAATNFPTNFIESIKFVADMPHRQLRFGDIAPFIPDMDMKKNNLLVVLHGFYTVHSLSGGSSLTHWRNLMESPVSREMARDMVNLILAGTPVEVQVELAKLGIPTPVDYKDDDK
>T0778 HR9155B, human, 127 residues	MGHHHHHHSHMQQAISEKDRGNGFFKEGKYERAIECYTRGIAADGANALLPANRAMAYLKIQKYEEAEKDCTQAILLDGSYSKAFARRGTARTFLGKLNEAKQDFETVLLLEPGNKQAVTELSKIKK
>T0779 MmR495A, , 68 residues	MEELSGKPLSYAEKEKLKEKLAFLKKEYSRTLARLQRAKRAEKAKNSKKAIEDGVPQPEALEHHHHHH
>T0780 SP18142A - SP_1560, Streptococcus pneumoniae TIGR4, 259 residues	MKKNSLYIISSLFFACVLFVYATATNFQNSTSARQVKTETYTNTVTNVPIDIRYNSDKYFISGFASEVSVVLTGANRLSLASEMQESTRKFKVTADLTDAGVGTIEVPLSIEDLPNGLTAVATPQKITVKIGKKAQKDKVKIVPEIDPSQIDSRVQIENVMVSDKEVSITSDQETLDRIDKIIAVLPTSERITGNYSGSVPLQAIDRNGVVLPAVITPFDTIMKVTTKPVAPSSSTSNSSTSSSSETSSSTKATSSKTN
>T0781 SP17834A - RUMGNA_02398, Ruminococcus gnavus ATCC 29149, 420 residues	MKKMEKKWPFVFNGIVIFCLILLILGMRWQAKKEESEVLNVTESLQKESEITSFSEEEEAVLYMLSALKKNDLDMALRGCAIDETALQINFVKTAEELPGMQLIDLPAPTSDYSYYFPLTSAEMTKAYIEQFEELSTEIPEIETLEVLEIAEKKEKEREEQLAECLAAQEVSELEIYVKCGEQSYRLGFTAVQYEKNWKIHSLKEGLLYETDIPACVQMEEMREAKKTYVLPNQLTGANYFQAMPISEKTPQRAVEQFIYAIEKGDLTRALAFATTESSQDTSPELLKKQGEYAKELKTMLYGFLGTEDARLYGKSEEQLNKLRGKLNPEYMVYLDLIKVIPIETEENTETVKQYAGLYSYNGKNYLTGYTLCRQEDGWQIQSLSAPALSLESGEVMRLSKEESRKTSEQSVLKAEKNER
>T0782 SP13538A - BACUNI_01346, Bacteroides uniformis ATCC 8492, 135 residues	MMKLHLKYLWIVLVACTLTACMNGGGDLAGKWQLRQYQYADGTSEKVDSVFYNFQKGSFSAICLLKDGGLTTFFGNYSLKGAEISIILLPESVNDKNYDTYFGWPEGKCTFKVEDLSYSSLRLEYEGTKSIFRKF
>T0783 ISPD, Homo sapiens, 411 residues	SMHPQAVAAVLPAGGCGERMGVPTPKQFCPILERPLISYTLQALERVCWIKDIVVAVTGENMEVMKSIIQKYQHKRISLVEAGVTRHRSIFNGLKALAEDQINSKLSKPEVVIIHDAVRPFVEEGVLLKVVTAAKEHGAAGAIRPLVSTVVSPSADGCLDYSLERARHRASEMPQAFLFDVIYEAYQQCSDYDLEFGTECLQLALKYCCTKAKLVEGSPDLWKVTYKRDLYAAESIIKERISQEICVVMDTEEDNKHVGHLLEEVLKSELNHVKVTSEALGHAGRHLQQIILDQCYNFVCVNVTTSDFQETQKLLSMLEESSLCILYPVVVVSVHFLDFKLVPPSQKMENLMQIREFAKEVKERNILLYGLLISYPQDDQKLQESLRQGAIIIASLIKERNSGLIGQLLIA
>T0784 SP13500A - BACOVA_05332, Bacteroides ovatus ATCC 8483, 155 residues	MKKRILSLLGVIALFLGVILVSCGNDDDNKNTTGVHKIVVEQSGNTDDFDLNIAFGAANTGGVAKLYNENGEYLGDSYLVNKVTENKISCQTGKEGSMMTCAGSVISTSEQAGKKLKISVIAYIDNKEVNRLEKEYITKGSTLVENFSVSTTSVE
>T0785 snake adenovirus type 1 fibre head, snake, 115 residues	GRIPSPPSKTSLDIAEELQNDKGVSFAFQAREEELGAFTKRTLFAYSGDGLTGPFKAPASAELSSFLTAHPKGRWLIAFPLGTGIVSVDEGILTLEISRSLPEVGSGSSFYLTEK
>T0786 MH12279D - BCE0241 , Bacillus cereus, 264 residues	MDTQQLYFLNDIGKQKPESIRNRSAACPFCDRENLTDILATEGSIIWLKNKFPTLKDTFQTVLIETDNCEDHIATYTEEHMRSLIRFSIKHWLNLQKNEEFTSVILYKNHGPFSGGSLHHAHMQIIGMKYVNYLDNVEQDNFQGVIVQKNEHIELNISDRPIIGFTEFNIIIEDIGCIDELANYIQQTVRYILTDFHKGCSSYNLFFYYLNEKIICKVVPRFVVSPLYVGYKIPQVSTKIEDVKIQLAAYFTKQNDAIIHKKIE
>T0787 HIV-1 ENV TRIMER BG505 SOSIP.R6.664 (gp41 subunit), human, 153 residues	AVGIGAVFLGFLGAAGSTMGAASMTLTVQARNLLSGIVQQQSNLLRAPEAQQHLLKLTVWGIKQLQARVLAVERYLRDQQLLGIWGCSGKLICCTNVPWNSSWSNRNLSEIWDNMTWLQWDKEISNYTQIIYGLLEESQNQQEKNEQDLLALD
>T0788 HIV-1 ENV TRIMER BG505 SOSIP.R6.664 (gp120 subunit), , 481 residues	AENLWVTVYYGVPVWKDAETTLFCASDAKAYETEKHNVWATHACVPTDPNPQEIHLENVTEEFNMWKNNMVEQMHTDIISLWDQSLKPCVKLTPLCVTLQCTNVTNNITDDMRGELKNCSFNMTTELRDKKQKVYSLFYRLDVVQINENQGNRSNNSNKEYRLINCNTSAITQACPKVSFEPIPIHYCAPAGFAILKCKDKKFNGTGPCPSVSTVQCTHGIKPVVSTQLLLNGSLAEEEVMIRSENITNNAKNILVQFNTPVQINCTRPNNNTRKSIRIGPGQAFYATGDIIGDIRQAHCNVSKATWNETLGKVVKQLRKHFGNNTIIRFANSSGGDLEVTTHSFNCGGEFFYCNTSGLFNSTWISNTSVQGSNSTGSNDSITLPCRIKQIINMWQRIGQAMYAPPIQGVIRCVSNITGLILTRDGGSTNSTTETFRPGGGDMRDNWRSELYKYKVVKIEPLGVAPTRCKRRVVGRRRRRR
>T0789 EspG3_M_tuberculosis, human, 295 residues	MDATPNAVELTVDNAWFIAETIGAGTFPWVLAITMPYSDAAQRGAFVDRQRDELTRMGLLSPQGVINPAVADWIKVVCFPDRWLDLRYVGPASADGACELLRGIVALRTGTGKTSNKTGNGVVALRNAQLVTFTAMDIDDPRALVPILGVGLAHRPPARFDEFSLPTRVGARADERLRSGVPLGEVVDYLGIPASARPVVESVFSGPRSYVEIVAGCNRDGRHTTTEVGLSIVDTSAGRVLVSPSRAFDGEWVSTFSPGTPFAIAVAIQTLTACLPDGQWFPGQRVSRDFSTQSS
>T0790 EspG3_M_smegmatis, human, 293 residues	MGPNAVELTTDQAWCLADVLGAGSYPWVLAITPPYSDHSQRSAFLAAQSAELTRMGVVNSAGAVDPRVAQWITTVCRATQWLDLRFVSGPGDLLRGMVARRSEETVVALRNAQLVTFTAMDIGHQHALVPVLTAGLSGRKPARFDDFALPAAAGARADEQIRNGAPLAEVLEFLGVPPSARPLVESVFDGRRTYVEIVAGEHRDGHRVTTEVGVSIIDTPHGRILVHPTKAFDGEWISTFTPGSADAIAMAVERLTASLPSGSWFPDQPLTRDFDEDAATHREPVLQRRTQKA
>T0791 EspG5_M_tuberculosis, human, 300 residues	MDQQSTRTDITVNVDGFWMLQALLDIRHVAPELRCRPYVSTDSNDWLNEHPGMAVMREQGIVVNDAVNEQVAARMKVLAAPDLEVVALLSRGKLLYGVIDDENQPPGSRDIPDNEFRVVLARRGQHWVSAVRVGNDITVDDVTVSDSASIAALVMDGLESIHHADPAAINAVNVPMEEMLEATKSWQESGFNVFSGGDLRRMGISAATVAALGQALSDPAAEVAVYARQYRDDAKGPSASVLSLKDGSGGRIALYQQARTAGSGEAWLAICPATPQLVQVGVKTVLDTLPYGEWKTHSRV
>T0792 Oskar-N, , 80 residues	ESNYISVREEYPDIDSEVRAILLSHAQNGITISSIKSEYRKLTGNPFPLHDNVTDFLLTIPNVTAECSESGKRIFNLKAS
>T0793 CcH, Staphylococcus aureus, 595 residues	MSYTLFEIGPFALDSFGWKETIPPKKDGDSEKVVRMASPIIVNARFSDPITGVEKLIITNNNGKKDIFESDILTTRNLPSLIKYGYSINEKYIRSLSYALQLMRDRLPLSELYEGVGILETPFGYLISLDKVLKSIQFNQSSPSYPIVDSAYDLTPKGTFDNWFNMYIDEVKGHLLLELAVIFGISALVTSFLKHKHEIEFAGILFSFTGQSSTGKSTAAALAVSVAGNPTKGNETLFRSWNATRNALEGYLSNNYGIPIVFDELSSTTLRDTTGLLYSIAEGQGRQRSNVHGEVKTPKNWGTSVISTSEYSIFNDSAQNDGLRVRTIEINEQFTTNATNADNIKKAVALNYGHVLPLVAKYLINREDEVIQWFYKEVDWFEAKLKDETNNTGIRMFKRYAVITTSAKILGRVLSTDIDIANIRDYFIDYHTHTVSERSLADKAIDVIIQFVAQNRGKFSDEGALKNMFENYGLISLKDDHIEVKIIANVFKQMLNNHQFQDVNNVVNALRDKGFILADRGRQTTKRSVKDNSGKKQSLVFYHLKLDVEFASILGLTKDKSLLQNWTPSNDNKAAKELFKSANEGIGPSGVHEDF
>T0794 Vanin, Human, 470 residues	QDTFIAAVYEHAAILPNATLTPVSREEALALMNRNLDILEGAITSAADQGAHIIVTPEDAIYGWNFNRDSLYPYLEDIPDPEVNWIPCNNRNRFGQTPVQERLSCLAKNNSIYVVANIGDKKPCDTSDPQCPPDGRYQYNTDVVFDSQGKLVARYHKQNLFMGENQFNVPKEPEIVTFNTTFGSFGIFTCFDILFHDPAVTLVKDFHVDTIVFPTAWMNVLPHLSAVEFHSAWAMGMRVNFLASNIHYPSKKMTGSGIYAPNSSRAFHYDMKTEEGKLLLSQLDSHPSHSAVVNWTSYASSIEALSSGNKEFKGTVFFDEFTFVKLTGVAGNYTVCQKDLCCHLSYKMSENIPNEVYALGAFDGLHTVEGRYYLQICTLLKCKTTNLNTCGDSAETASTRFEMFSLSGTFGTQYVFPEVLLSENQLAPGEFQVSTDGRLFSLKPTSGPVLTVTLFGRLYEKDWASNASSG
>T0795 raptor adenovirus fibre head, , 141 residues	GEGVSYSDGHFLTKSGGVINFRKTRVTSITITILGNYGLRVVNGELQNTPLTFKGADFKSSTLKDELLIPLEGAVQLNTAPSTALCIFITTDHVYRELCMMQFLTDVDKTPFLVVLRSESKHETIQYMHIVTVHPFLSLTA
>T0796 ABI14444.1, , 309 residues	MIFLAILDLKSLVLNAINYWGPKNNNGIQGGDFGYPISEKQIDTSIITSTHPRLIPHDLTIPQNLETIFTTTQVLTNNTDLQQSQTVSFAKKTTTTTSTSTTNGWTEGGKISDTLEEKVSVSIPFIGEGGGKNSTTIEANFAHNSSTTTFQQASTDIEWNISQPVLVPPRKQVVATLVIMGGNFTIPMDLMTTIDSTEHYSGYPILTWISSPDNSYNGPFMSWYFANWPNLPSGFGPLNSDNTVTYTGSVVSQVSAGVYATVRFDQYDIHNLRTIEKTWYARHATLHNGKKISINNVTEMAPTSPIKTN
>T0797 PKGII leucine zipper, , 44 residues	KDAELQEREYHLKELREQLAKQTVAIAELTEELQSKCIQLNKLQ
>T0798 Rab11b, , 198 residues	YDYLFKVVLIGDSGVGKSNLLSRFTRNEFNLESKSTIGVEFATRSIQVDGKTIKAQIWDTAGQERYRAITSAYYRGAVGALLVYDIAKHLTYENVERWLKELRDHADSNIVIMLVGNKSDLRHLRAVPTDEARAFAEKNNLSFIETSALDSTNVEEAFKNILTEIYRIVSQKQIADCAAHDESPGNNVVDISVPPTTD
>T0799 pb1 plus chaperone domain, , 408 residues	CSFGIENTAGGSAVFHNYTRGASNSVTKNNQLLGGYGSRPWLGSTYTEHSNAALHFLGAGDTSATNHGGWIRLLVTPKGKTISDRVPAFRLSDNGDLWLVPDGAMHSDLGLVRSIETLNAAVPRFNAPSIQDGRGLKIVAPQAPEIDLIAPRGSGASAPAIRAMWCDGSLADTTRYIGATQPGSTFYIGASGHDGEKFDSMRGSVAIKSAGGWGPTSTPTQVVLETCESGSISRLPRWGVDHNGTLMPMADNRYNLGWGSGRVKQVYAVNGTINTSDARLKNDVRAMSDPETEAAKAIAKEIGFWTWKEQADMNDIREHCGLTVQRAIEIMESFGLDPFKYGFICYDKWDEHTVVSEYGPANEDGTENPIYKTIPAGDHYSFRLEELNLFIAKGFEARLSAIEDKLGM
>T0800 SP18282A - CLOSPO_03726 , Clostridium sporogenes, 247 residues	MNIKKLFSIFTLVILVFATACTNKSEKATVSDTNEKPKEEIKIVEPNGAEKTKLNLNFGVGKLNISGNEEKLMKGKFIYSENEWKPEIKYEVKDKDGELEISQPGLKSGNVSLNNKRNEWNINLNEKIPTEIKLSLGTGEFKADLSKINLKELNVGMGVGKVDLDISGNYKNNVKVNIEGGVGEATVYLPKSIGVKIKAEKGVGAVNANGFIVEGENIYKNSQYGKSKNSIEVNIEAGVGAINIKQK
>T0801 WecE, , 376 residues	MIPFNAPPVVGTELDYMQSAMGSGKLCGDGGFTRRCQQWLEQRFGSAKVLLTPSCTASLEMAALLLDIQPGDEVIMPSYTFVSTANAFVLRGAKIVFVDVRPDTMNIDETLIEAAITDKTRVIVPVHYAGVACEMDTIMALAKKHNLFVVEDAAQGVMSTYKGRALGTIGHIGCFSFHETKNYTAGGEGGATLINDKALIERAEIIREKGTNRSQFFRGQVDKYTWRDIGSSYLMSDLQAAYLWAQLEAADRINQQRLALWQNYYDALAPLAKAGRIELPSIPDGCVQNAHMFYIKLRDIDDRSALINFLKEAEIMAVFHYIPLHGCPAGEHFGEFHGEDRYTTKESERLLRLPLFYNLSPVNQRTVIATLLNYFS
>T0802 bovine adenovirus 4 fibre head, , 122 residues	GALTTSTRQGSRVVGFMDFIIALGWQIIPSNIRYIYILNCSQFMPTSDVTTIYFQADSGLESIFVMDSPFYASCTQQLPDKTIKTYGVTISKKQSIISINFSSSLEPNIMVSAWTASITRTQ
>T0803  PilA1, Clostridium difficile, 139 residues	SNINKAKVASVESDYSSIKSAALSYYSDTNKIPVTPDGQTGLNVLETYMESLPDKADIGGEYKLIKVGNKLVLQIGKDGEGVTLTEAQSAKLLSDIGKDKIYTGVTGDNFGEQLKDTTKIDNKALYIVLIDNTVMDSTK
>T0804 murine adenovirus fibre head, , 202 residues	GALTAQGASFFTAAPLSYNTGNSTISLDYRSPQLRVSGGALALTSPVFVYQTPFNTPMRLRNGTYNEYADAHIQMVRFGTTVLFNIDVTGETNATGTQTWELQFDGTLGSCLTGRMQVMGGTGEELDVTPTFILPTSDKSVYKQGFMPIVCSENGEFKQSTYCSYALTYRLGNFYITLKSTTSGCKPIFQMSFMYESQIGIV
>T0805 nitroreductase Rv3368 , M.tuberculosis, 214 residues	MTLNLSVDEVLTTTRSVRKRLDFDKPVPRDVLMECLELALQAPTGSNSQGWQWVFVEDAAKKKAIADVYLANARGYLSGPAPEYPDGDTRGERMGRVRDSATYLAEHMHRAPVLLIPCLKGREDESAVGGVSFWASLFPAVWSFCLALRSRGLGSCWTTLHLLDNGEHKVADVLGIPYDEYSQGGLLPIAYTQGIDFRPAKRLPAESVTHWNGW
>T0806 YaaA, E. coli K-12, 258 residues	MLILISPAKTLDYQSPLTTTRYTLPELLDNSQQLIHEARKLTPPQISTLMRISDKLAGINAARFHDWQPDFTPANARQAILAFKGDVYTGLQAETFSEDDFDFAQQHLRMLSGLYGVLRPLDLMQPYRLEMGIRLENARGKDLYQFWGDIITNKLNEALAAQGDNVVINLASDEYFKSVKPKKLNAEIIKPVFLDEKNGKFKIISFYAKKARGLMSRFIIENRLTKPEQLTGFNSEGYFFDEDSSSNGELVFKRYEQR
>T0807 oxidoreductase, Klebsiella pneumoniae 342  , 284 residues	MVKKTVRFGEQAAVPAIGLGTWYMGEHAAQRQQEVAALRAGIDHGLTVIDTAEMYADGGAEEVVGQAIRGLRDRVVLVSKVYPWHAGKAAMHRACENSLRRLQTDYLDMYLLHWRGDIPLQETVEAMEKLVAEGKIRRWGVSNLDIEDMQALWRTADGEHCATNQVLYHLASRGIEYDLLPWCQQHSLPVMAYCPLAQAGRLRDGLFQHSDIINMANARGITVAQLLLAWVIRHPGVLAIPKAASIEHVVQNAAALDIVLSGEELAQLDRLYPPPQRKNRLDMV
>T0808 SP16782A - BACCAC_02064, Bacteroides caccae , 418 residues	MKNLLCLLALLLCTTVFAQPQQVVVGVSGNGYVTRQQDGARITQRGVTHWTNPKSIVSIYFYLHQPTTADLSLYAKGHSEIKVSYGKKGFKVNLQSNDFTKVPVGSIDIRQAGYVRIDLQGVSKSGEGFGEIKQLIADNVTGKSNYVKDFSDYWGRRGPSVHLGYALPEGDTEWFYNEITVPKEGETMHSYYMAAGFGEGYFGMQYNSPTERRILFSVWSPFDTQNPKEIPDDQKIKLLRQGKDVHIGEFGNEGSGGQSYLKYPWKAGNTYKFLMQIRPDGNGNTTYTAYFYATDEKEWKLIASFLRPKTNTWYKRPHSFLENFSPEQGYLSREVFFGNQWARSKEGKWSRLTDATFTHDATASAQVRLDYQGGNTKDNRFYLKMGGFFNESVPMGTKFYCKPTGKEPEIDWEALKQL
>T0809 FtsH-N, , 62 residues	RKVDYSTFLQEVNNDQVREARINGREINVTKKDSNRYTTYIPVQDPKLLDNLLTKNVKVVGE
>T0810 Q6MI90_BDEBA, Bdellovibrio bacteriovorus, 383 residues	MYMKKLVFGGMLIVSAASLVGCGSQIGSSVRQAVSDNQSAQTLVEWENSEANPEALFANWRHEFMVDSSKRESMKTELCKELQALPAQDLTLFENEIRDENNRALVSGCKEELLAQVDEHFDEQRESMSVPGHALKAVQSRNSFRFPDNTQKRDMSNGYMAVRGDVARKEVVLTFDDGPHGLYTDAILRALKEVNAKAMFFATGKSVRTNPEALKRVAADGHVIGSHSITHACLGTSVACYKQMGNRNLTFDEAAAEVRGGHQAVFDVLGWVDPVFRFPYGETSKDLKAFLKTKSTGEFAWNIESDDWRTQSNEQLLARVLANVESQGRGIVLFHDIQRRTAEIMPQFLRELYNRGYSVVLLTAADPSAKYNSKLVKRKQQLP
>T0811 triosephosphate isomerase, Sinorhizobium meliloti, 255 residues	MSKSGLWVGTSWKMNKTLAEAMVFADGLAAADDARDQRIQRFVIPPFTAARQVKERLKATSVKVGAQNMHWDDAGAWTGEISPVMLSDCDLDIVELGHSERREHFGETDRTVGLKTAAAVKHGLVPLICIGETLAQREAGEADTVLKRQVEGAFAFLEGAARKAPVLLAYEPVWAIGVNGIPATADYADARHRLIGEVAERALGVKVPVLYGGSVNPQNCEELILQPHIDGLFIGRSAWDVGGYLDILQRVARAI
>T0812 laminin, human, 204 residues	SEAKGLIRTWVTLKAEQTILPLVDEALQHTTTKGIVFQHPEIVAHMDLMREDLHLEPFYWKLPEQFEGKKLMAYGGKLKYAIYFEAREETGFSTYNPQVIIRGGTPTHARIIVRHMAAPLIGQLTRHEIEMTEKEWKYYGDDPRVHRTVTREDFLDILYDIHYILIKATYGNFMRQSRISEISMEVAEQGRGTTMTPPADLIEK
>T0813 Prephenate dehydrogenase, Sinorhizobium meliloti, 307 residues	MAQQFQTIALIGIGLIGSSIARDIREKQLAGTIVVTTRSEATLKRAGELGLGDRYTLSAAEAVEGADLVVVSVPVGASGAVAAEIAAHLKPGAIVTDVGSTKGSVIAQMAPHLPKDVHFVPGHPIAGTEHSGPDAGFAGLFRGRWCILTPPAGTDEEAVARLRLFWETLGSMVDEMDPKHHDKVLAIVSHLPHIIAYNIVGTADDLETVTESEVIKYSASGFRDFTRLAASDPTMWRDVCLHNKDAILEMLARFSEDLASLQRAIRWGDGDKLFDLFTRTRAIRRSIVQAGQDTAMPDFGRHAMDQK
>T0814 SP13528A, Parabacteroides merdae ATCC 43184, 424 residues	MKMRVYSLLFMMLFALSIGANAQVKFFTDVNSKQIKTLQVKVAGELISEPYIALGGEEQIEINFDGLGSGYTRYAYNVVHCNADWTQSQLSPIEYMNGFQGTTIDDFANSIGTTTQYSNYRLLLPNDDVQFKVSGNYAIQVYNEDTPDQIIFTACFSVVEPVVNISASVSGNTDIDTNQSHQQVSFNINNKNFPITYPQTDLKIFVYQDNRRDNAVTDLQPMSILENQISYTYNRNLIFPAGNEYRRMEFLSNKYNGMHVENISFHNPYYNVELMTDYRRDKGTYQYDQDQDGRFFIRCSDCNDPDTEADYYIVHFTLACDPLPDGSVYLNGELFNNVLDEKSKMGYNFETKQYEKAVLLKQGSYNYQYLFVPTGSSVGQTGPIEGNYYQTQNEYSIYVYYRPMGARYDRLIGVTTVRNEMQVF
>T0815 SnoaL-like polyketide cyclase, Sinorhizobium meliloti 1021, 106 residues	MDLPDIVNMYFDADSCNDTDALSETFAPDAVVEDEGARHQGVVAILRWWVAAKKAASYVAEPLESTVDGDKALVRAKVSGRFPGSPVTLTYSFTIKDGRIARLEIQ
>T0816 Af1502, Archaeoglobus fulgidus, 68 residues	MITYKKLLDELKKEIGPIAKIFLNKAMESLGYDDVDDSNYKEILSVLKMNKELREYVEIVEERLEKEG
>T0817 ABC transporter substrate-binding protein, Sinorhizobium meliloti, 525 residues	MSVKRRTFLQGAAGAIGLAMAQGALSKIVYAQGAAGTLRVAIAKPAGNLDPQSHYAIWAIQDLMFEPLVKYGKGGQIEPCLATDWKIEDGGKTLHLTLREGVKFQDGTKFDAAACKWNLERWMGIDQFSWMNCSKHFQSLEVVDDYHITVHFKEPVLALMQELSYTRPTRFLSPKSVDADGKFKEPVGTGPWVQISADDTQSVFEHYDGYWGDKPTYERLEAKVIPDARSRVAALRAGEIDLVGGFWIAPLTPEEGKQLEAAGFNVVVDPGNVTLVMAFNPDRAEPLKDPQVRKAVSIGIDRAAISKVLYHGYAKPAGNMFSAALPYAGKQFDAPVRDAAAASALLEKAGWTGSPIRSKDGKPLTLELVVSPDAVPGSRVIAEVIQSEMKEVGIDLVIRSVDHASKHTDMLEQKYDLGFFLTYGAPYDPFGSLVALCLSTFKNDVEGKLVTDPVNLDPLINAATAATGDQIEPTIQKVYDWLRDNDAIAPLVYVPSIWAHSKRVQGFTSPVTEYDMPYENIVLAE
>T0818 SP17906A - EUBSIR_01394, Eubacterium siraeum, 166 residues	MDSLVKIMGSFLALSLIMIFSSCIVNEHVDEGNIKENAVRMMECIVNKDSEKLFDFYNKDMKDNYKDSSLDEIRQLFEYIDGAITSYNYEGKGGGQEAKNDGIICYYSCHPEFDFTTETGQEYTISFSYHYIWNEHPEYEGINMIQICKDGNWGEKLIIGRNYYKE
>T0819 histidinol-phosphate aminotransferase, Sinorhizobium meliloti, 373 residues	MSAFSRFTPLIQSLPASVPFVGPEALERQHGRKIAARIGANESGFGPAPSVLLAIRQAAGDTWKYADPENHDLKQALARHLGTSPANIAIGEGIDGLLGQIVRLVVEAGAPVVTSLGGYPTFNYHVAGHGGRLVTVPYADDREDLEGLLAAVGRENAPLVYLANPDNPMGSWWPAERVVAFAQALPETTLLVLDEAYCETAPRDALPPIESLIDKPNVIRARTFSKAYGLAGARIGYTLSTPGTAQAFDKIRNHFGMSRIGVAAAIAALADQDYLKEVTLKIANSRQRIGRIAADSGLAPLPSATNFVAVDCGKDASYARAIVDRLMSDHGIFIRMPGVAPLNRCIRISTAPDAEMDLLAAALPEVIRSLAAT
>T0820 VCID6010, Unknown, 140 residues	GSETTIILTDDGVTDIGMARNTIHQMVGLVDDLVASEATASQLREALYAALARGLGFQASVGQSSPLLLRRSVLLSLRGLARRLARIEADALTDDIQPRDIVLSAKELSEWLQEGDVVTVTIPGGPCTRYRILEGDTSNG
>T0821 SP13833A - PARMER_03812, Parabacteroides merdae, 275 residues	MRTFLIIIGLFLFIGNSFAQSYEELIEKSYDFVDKGDLVSAEESLKAAMRKEPANPLNYALLTNLGTIQRRQGKLQEALISYTSALSGHTKNITILENRASLYTELGETEKALNDYNTLLIENPEHQEALYCRGLLYIQLQNYMWAEQDFDKILEVNEKSVRARLGHAILEKMRGNYDESERIFNYLISEMPRDWILYEGRADLYFMMGKNARAMADIEKVFTESEPTANLYVLRGKIKLAQYEKERAALDFKKAESMGYNKEVIKELLKLTMNN
>T0822 Rf136, , 121 residues	MGPVAGNYVHDFTANGTSSSFYTIAGNLSTSKGTATYNGKTLTQCLKMETATSISFTAPSAGKLTLVFAEAAATAKVDGNKVTASNGIITVDLAQGAHTITKADACNLFYMEYAAHHHHHH
>T0823 CC2504, Caulobacter crescentus , 296 residues	MRYRPFGSTGVAVSALTLRLADNPRLRANDWRALVFTALENGVNSFQIDGDAPELLKGAGEAFASVERHLLFLTWRLRGDAKQLGPHTLDALKRSAFEGLSLDYLDLLLINDPQSASLPMAFESGLQDLQKGRALRGLGVASRGDIDPGLLANDLVTAVSSPYNLSSGWAERHRIRQASQNNFAVIGEDFWPQALREVADKAPPKPSFWQRRTDPLADVGGYEFLTNTPGWSAEDICLGYALTEPSLATVRVTADNRQEIERLAAVVERDLPTGVCAQIEMARFSAQEREKAARRP
>T0824 nucB, , 110 residues	AARYDDVLYFPASRYPETGAHISDAIKAGHADVCTIERSGADKRRQESLKGIPTKPGFDRDEWPMAMCEEGGKGASVRYVSSSDNRGAGSWVGNRLNGYADGTRILFIVQ
>T0825 WRAP-5, , 205 residues	SSSVWGVAFSPDGQTIASASDDKTVKLWNRNGQLLQTLTGHSSSVWGVAFSPDGQTIASASDDKTVKLWNRNGQLLQTLTGHSSSVWGVAFSPDGQTIASASDDKTVKLWNRNGQLLQTLTGHSSSVWGVAFSPDGQTIASASDDKTVKLWNRNGQLLQTLTGHSSSVWGVAFSPDGQTIASASDDKTVKLWNRNGQLLQTLTGH
>T0826 NmLptA, , 544 residues	MIKPNLRPKLGSSALIAFLSLYSSLVLNYAFFAKVVELHPFNGTGADIFLYTMPVVLFFLSNFVFHVIALPFVHKVLIPLILVISAAVSYQEIFFNIYFNKSMLNNVLQTTAAESARLITPGYVLWIVCLGVLPALAYIAVKVKYRVWYKELLTRLVLAAVSFLCALGIAMLQYQDYASFFRNNKSVTHLIVPSNFIGAGVSKYKDWKRSNIPYTQLDMAVVQNRPAGSLRRFVVLVVGETTRAANWGLNGYSRQTTPLLAARGDEIVNFPQVRSCGTSTAHSLPCMFSTFDRTDYDEIKAEHQDNLLDIVQRAGVEVTWLENDSGCKGVCGKVPNTDVTSLNLPEYCRNGECLDNILLTKFDEVLNKNDKDAVLILHTIGSHGPTYYERYTEAERKFTPTCDTNEINKCTRATLVNTYDNTVLYVDQFIDKVIRKLENRDDLESVVHYVSDHGESLGENGMYLHAAPYAIAPSGQTHIPMVMWFSKAFRQHGGIDFQCLKQKAAENEYSHDHYFSTVLGLMDISNSQTYRKEMDILAACRRPR
>T0827 CC0948, Caulobacter crescentus , 407 residues	MSEAALTPAFEEPEAPRASPRSRSTLLKRLADVVCLPSSRINAFERSMTADLLVEMLRDANVGEREKVARRLAMLNEMPGVLVRLLLRDELPVARALLVDSEKLSDADLISCLYQATTEHRRLIAQRRGVSEVVADALIEVGEPAVIETLLRNELVKLSHQGVENIVAATRDAQHLIPLLLRRAELRPSHAYVMFWWADSEARRVILQRFAVSREILQDAVGDVFALASAEGWQDPLSRKALQFIERRQRNRAAIAKSPFNSLDEAVAAGEGGFNREIAEEISYLSGLKPMTGAKIFTDPGGEPLAILCKATGLPRGCVRQLWRGLRRQEVDRTGATDPNLERVLTVYDAIAVDRAQTVLRYWNWSLTSALTPALLKAIRDGDEAAVDEYSAPQRAAMLALSRDFGR
>T0828 MtxA, Magnetospirillum gryphiswaldense, 325 residues	MASWSHPQFEKGADDDDKSEPPVSMLMQVAGAVETSKGGEKWAPVTRNKFLFVGTQVRTGADGGGKLIDQNSGMAQTIGANSVVEITAAGPKAVSGSLSAPEAASGDLVAGLSNRFAEAQRYTTVRRSVKKEAADLKLRVASDITLSPTYPDLVWENMGAQYGYTLVIDGTSHAVPATSGEMVRFRVPSLTPGAHSFGVTVTEGGQAVGQTEKGGTIVWLSATEDKALVDGVARVKAASTGDEFALGNYLDSKGVTVAAMDAYRKHFASHKDDNDMRPLLIKTYNDLKLRDLRQKEALVYNEQLEGNPGFSSISAHHHHHHHHHH
>T0829 hypothetical protein YPO2434, Yersinia pestis CO92, 70 residues	MQRQPVSSSRILSIGYDPDNRMLEIQFREQGTYQYLGVPERAHQNFMSAVSKGRFFDGVIKGKFLCRKIG
>T0830 UDP transferase, , 575 residues	MPQPTSQQRASVASSQSTQGAVGWSAATGWVVLFVAVALVVWFVSLDMRHLVGPDEGRYAEISREMFASGDWVTIRYNALKYFEKPPFHMWVTVVGYELFGLGEWQARLAVALSGLLGIGVSMMAARRWFGARAAAFTGLALLAAPMWSVAAHFNTLDMTLAGVMSCVLAFMLMGQHPDASVAARRGWMVACWAAMGVAILTKGLVGIALPGLVLVVYTLVTRDWGLWRRLHLALGVVVMLVITVPWFYLVSVRNPEFPNFFFIHEHWQRYTSNIHSRSGSVFYFLPLVIGGFLPWAGIFPKLWTAMRAPVEGTQARFRPALMAGIWAIAIFVFFSISRSKLPGYIVPVIPALGILAGVALDRLSPRSWGKQLIGMAIVAACGLLASPVVATLNANHIPNSFYRAYAVWVAVAFVVMLLGIAVARLLLRRGVLPSVAVYAMGMYLGFTVALLGHETVGRPASGADIAPQIAQKLTPEMPLYGVQMLDHTLPFYLRHPLMMVGQADELTFGATVEPQRVVPDVDSFTKLWKNGQPAMAVMSPDTYLALAPTLSMYVVARDWRRVVVANVASLAGPQ
>T0831 SHPRH, Homo sapiens, 419 residues	TMEELLTSLQKKCGTECEEAHRQLVCALNGLAGIHIIKGEYALAAELYREVLRSSEEHKGKLKTDSLQRLHATHNLMELLIARHPGIPPTLRDGRLEEEAKQLREHYMSKCNTEVAEAQQALYPVQQTIHELQRKIHSNSPWWLNVIHRAIEFTIDEELVQRVRNEITSNYKQQTGKLSMSEKFRDCRGLQFLLTTQMEELNKCQKLVREAVKNLEGPPSRNVIESATVCHLRPARLPLNCCVFCKADELFTEYESKLFSNTVKGQTAIFEEMIEDEEGLVDDRAPTTTRGLWAISETERSMKAILSFAKSHRFDVEFVDEGSTSMDLFEAWKKEYKLLHEYWMALRNRVSAVDELAMATERLRVRDPREPKPNPPVLHIIEPHEVEQNRIKLLNDKAVATSQLQKKLGQLLYLTNLEK
>T0832 APC108134, , 257 residues	MFFSKDEKNPIKRALQGELLQNEPFIQLCTKIENYLMDTEAVNEQLIELNEQLTMRLKEKGLKPGEKGATKQLRTLIQEILTEAGFREGMLQTIGNKPLKKEDFMFLVSSGFMLKDSSLRASSHGELTHAIQWCLIILKQKKDSSFLENIPTSEICDRIYKKLGHQDSSNPNYPFTCWDVLIDKLGEIDSRSPEWLSDHIQNDEDQIFPVLREVIKNRTEKGKTEENKGKLQKKLENPPEHYEKHEEIENILMPKPK
>T0833 SP13991A - BDI_3222 , Parabacteroides distasonis ATCC 8503, 136 residues	MKTSVWGKSILALVFTFMCSLAISAASPKDYLYDTKEENGKIISKVVFLQENGLLNKQVRYEFQYNENGKVSEKKAFRWDRTNDEWVPFYQITYQYDDQSGEIKTNYGMWDKKKKNFSLNVQNMIIPSTNYEEIFS
>T0834 IDP04043, , 219 residues	DSLPERIDLFVSLFDYNSATTSYDIRSIQTDFPTRLLTPDSMLPQTSEYPLKDIQLLYKLAQSCTGKLPLSPLITEPLVFTRSLCKGSSLSPRWFARSGLIHPGGGTYAFRYAEKYPAQFANLLPYMHIQERPNAAEGTLLYHLQNMGEDAINALVSGASMFGSGSDLWLRKGDIYYLFNEETWLTNANKAGLSYSLLSADNTCFIQRGNICWDVEDHS
>T0835 hypothetical protein YPO2471, Yersinia pestis CO92, 424 residues	MKLLNTLVCIIGLTSFSSSAKLVNAEHLDALYQKVTVANKTELGLIHIYSEFPDYRWVKDPIEGVSAIDDVARAAIFYQRQYQATGSAADLEKVKSLVEFILYQRADNGYFYNFIYPDHSINKEYKTSVAEPNWWTWRALWALTQVYPTLVKTDNALAQRTRETIFATIDVIYKDFNFKQTRGEKEGVAVPEWLPHTAGDQASVLLMALSDAQALEAKPEIEKMMRSLAAGIMLMQVKDTSSPVNGAFLSWQNLWHGYGNSQAYALLVAGNRLGDRDMIKAAFNELDHFHPWLISNGLLNEFTVRQQGEKVTLIEQKKFSQIAYIIRPMVFANIKAWEISRDAVYLERAVDLSLWFFKNNPAQAQMYYPVTGIAFDGIDSATTVNKNSGAESTIEALLTLQLIESIPDAKRMLESALEKRNIKQ
>T0836 CC_1988, , 204 residues	MTGLLSNFRNTIIVSFVLALVIVIGYGHSPHGHDATYFQAIFRWLHVLFGILWIGLLYYFNFVQIRVMPQIPAELKPAVSKYIAPEALFWFRWAALATWVMGVLLAYNRGYLVEAFTLGLAGGYTPGVDMGFTFIGTGMWLATVMFFNVWVFIWPNQKIALGIVEADADAKAKAAKTAMLVSRTNTLLSIPMLATMAMHQTLFG
>T0837 hypothetical protein YPO2654, Yersinia pestis CO92, 128 residues	SDTRKAIDTISNLLKIKPIYIESMLQEMGPRQTQMFIRSTSNGSAEEVRKAAYLVFIYHTFIKNPSDENVELWRNTLIRAQISPILAAEHTDAALFYFAELDLDAFELAQFRRHYNLHFNPEPGTLLH
>T0838 GS13694 - BVU_0573, Bacteroides vulgatus ATCC 8482, 154 residues	MKKVLLLVFLSLTWLSASAQALVPITWTAYGLTFEAPKGILVEEDTEETFLLNNSRFYITIQSLDSDGMTKSDLKSVLKDYANDDGVKDQSAVQEFELPQFFGTYLKGSCETDHCLYACLMTKAAGSGFYISIIYSKENENIAEKILKSFTMEE
>T0839 SLA2, , 262 residues	MATTRSLDHAKAEAELAINIKKATSPEETAPKRKHVRSCIVYTWDHKSSLSFWAGLKVQPILADEVQTFKALITIHKVLQEGHPVTLREAMANRGWIDSLSRGMMGEGVRGYGPLIREYVHFLLAKLSFHKQHPEFNGTFEYEEYISLKAIHDPNEGYETITDLMTLQDKIDQFQKLIFSHFRHIGNNECRISALVPLVAESYGIYKFITSMLRAMHSSTGDNEALEPLRQRYDAQHYRLVKFYYECSNLRYLTSLITIPKL
>T0840 RON Receptor Tyrosine kinase subunit, , 669 residues	RSEDWQCPRTPYAASRDFDVKYVVPSFSAGGLVQAMVTYEGDRNESAVFVAIRNRLHVLGPDLKSVQSLATGPAGDPGCQTCAACGPGPHGPPGDTDTKVLVLDPALPALVSCGSSLQGRCFLHDLEPQGTAVHLAAPACLFSAHHNRPDDCPDCVASPLGTRVTVVEQGQASYFYVASSLDAAVAGSFSPRSVSIRRLKADASGFAPGFVALSVLPKHLVSYSIEYVHSFHTGAFVYFLTVQPASVTDDPSALHTRLARLSATEPELGDYRELVLDCRFAPKLVPRGSPEGGQPYPVLQVAHSAPVGAQLATELSIAEGQEVLFGVFVTGKDGGPGVGPNSVVCAFPIDLLDTLIDEGVERCCESPVHPGLRRGLDFFQSPSFCPNPPGLEALSPNTSCRHFPLLVSSSFSRVDLFNGLLGPVQVTALYVTRLDNVTVAHMGTMDGRILQVELVRSLNYLLYVSNFSLGDSGQPVQRDVSRLGDHLLFASGDQVFQVPIQGPGCRHFLTCGRCLRAWHFMGCGWCGNMCGQQKECPGSWQQDHCPPKLTEFHPHSGPLRGSTRLTLCGSNFYLHPSGLVPEGTHQVTVGQSPCRPLPKDSSKLRPVPRKDFVEEFECELEPLGTQAVGPTNVSLTVTNMPPGKHFRVDGTSVLRGFSFMETGHHHHHH
>T0841 Macrophage Stimulating Protein (MSP) subunit, , 253 residues	FEKCGKRVDRLDQRRSKLRVVGGHPGNSPWTVSLRNRQGQHFCGGSLVKEQWILTARQCFSSCHMPLTGYEVWLGTLFQNPQHGEPSLQRVPVAKMVCGPSGSQLVLLKLERSVTLNQRVALICLPPEWYVVPPGTKCEIAGWGETKGTGNDTVLNVALLNVISNQECNIKHRGRVRESEMCTEGLLAPVGACEGDYGGPLACFTHNSWVLEGIIIPNRVCARSRWPAVFTRVSVFVDWIHKVMRLGHHHHHH
>T0842 BaheA.17330.a.B2.GE37429, , 146 residues	MAHHHHHHMVAMQSTIPSLTREEIADRMQHNPLVQAYQQEVMHWCKIVYGNSDVLKEKMQEVLQKPSEGEDLSRQVAENPTSVHKLAGRNLCGLKTNARRQAEEGFMHLCQALDGYTSAVTQAQENIKHVPQAEARRYGQESEQRA
>T0843 Ats13, Micromonospora echinospora, 369 residues	AMIPLFKVAVSPTALDRVAEVFASGYLGQGPRVAEFESALAARLGNPRVVSVHSGTSGLCLALRLLDAPEERDEVLSTPLTFEATNWAILADGRRITWVDVDPATLTMDLDDLERKISPATRAIIVVHWTGYPVDLDRLAGILDRAEREHGFRPAVIEDCAHAWGASYRGVPLGSHGNMCVFSFQALHLTCGDGGLLTLPGDELHERAMLRRFYGIDRTADRLRGAYDVAEWGLKWHMTDLNAAIGLANLETVDEQLRLHRENAAFYDKELTGVPGLELLQRSPDREGSFYVYDVKVDDRPAFHRKMEAAGIMAGLVSRRNDEHSCVAHLRTSLPGLDSVYDRMVSLPVGWWLTEQDREHVVATIRSGW
>T0844 BaroA.17330.c.B4.GE37268, , 145 residues	MAHHHHHHLIPAEQLPPLKEEEVIEKIENDACIQKSLEKIRALSKLIYNNPEILEQDISHINANPKMGRELSERIINSPKSIGRLKGRKIGYIKSQKYKISEQNAKILSNEIFNYADKVSNIRCTIMREHKAKGRRLLQTVKMPS
>T0845 GS13402A - BT1487, Bacteroides thetaiotaomicron, 448 residues	MNKLYTTLLIACLAAGFTACNDDDCEDLHLGNLAHYPNVLKGTFPTESQVLELGETLEITPELLNPEGATYSWLVNGKEYSTEPTFSYKIDNPCRADLSCIIKNKYGKVEMSTSFSSNHNFSKGFFYVADGTFNFYDTEKKTAYQDCYASLNAGKTLGIGNYDSANIIHSNGKFYLLVGTSTSNRDHFYIVDAKTLYYENSAVVGANLSGLTILNEQYGLVTGDGIRRIDLKSLNNVRIKNERLLCFYNSIIYNGKVLSNDTYKDESKVKYYDVNELIAAKEGEAPAVTELDIIQKQKINFVLAKDGNVYTLESADNGCNIVKIKNDFTLEKVFANFQPAKGPYHSSPTIGMVASETENIIYLVSTDGAIYKYILGDSDSLKAPFIAAESGVSITAPLQLNQQSGELYVTYTEERKDESKIVVYSKDGKVLHTVDCGESVPSQILFNN
>T0846 BaclA.17330.i.B2.GE37250, , 146 residues	MAHHHHHHFISPQKIVPLSYNEFIRKVVSDHSIQEQEKEIRRLSQIVFGNQNQLANQLSQIHENPSFTKIISNTLTNSPESFAKLAGSKTFGIKNSKRKQAEKNISKLVEAIHKYADAVENSMGNIIKNHNAEQKRLAQSVELPSD
>T0847 FAM83A, Homo sapiens, 176 residues	PYLKEKSSATVYFQTVKHNNIRDLVRRCITRTSQVLVILMDVFTDVEIFCDILEAANKRGVFVCVLLDQGGVKLFQEMCDKVQISDSHLKNISIRSVEGEIYCAKSGRKFAGQIREKFIISDWRFVLSGSYSFTWLCGHVHRNILSKFTGQAVELFDEEFRHLYASSKPVMGLKSP
>T0848 SP17471A, Bacillus subtilis, 354 residues	MFQKKTYAVFLILLLMMFTAACSGSKTSAEKKESETEKSSDIAQVKIKDVSYTLPSKYDKSTSDDQLVLKVNVAVKNTGKDPLNVDSMDFTLYQGDTKMSDTDPEDYSEKLQGSTINADKSVEGNLFFVVDKGKQYELNYTPESYGDKKPKSVTFKIDGKDKKILATADKLQDSAKALSAYVDVLLFGKDNADFEKITGANKNEIVNDFNESAKDGYLSASGLSSTYADSKALDNIVNGIKEGLSKNSSIQAKTTSISKDEAIVEATVKPVDASSLSDRIEDKVKDYYSKNSSASYEEAVKYALQVYPEEFKKLGPASSEKTVEVKMKKNDIDQWQLDMDDYRAAELVEAFIKE
>T0849 APC103457, , 240 residues	MNEPIILRYFPVLGRAQALRHALADAELAFRDLRIPLEQWSQHKDSDAGGPYGSLPTLRWHGVEVAETIAIASFLARSLGHYEGRDNGEIARLEAVVSLCYTEVSLQIAQLLWLDLFNPGVDLAAAVPLQFGRLVARLTRLEAHTPEAGWFGGERPVMADYFAAEAIEALRYLLGREHDDALRTRLPHLCALARRMAQRPALAQAWSTRPQTFTAHPDEAAMLERLRALPLAATIGASME
>T0850 U1 protein, Bas-Congo virus, 190 residues	ATMAFHPMLCRLELSVSAAPPASPIDATLLRSLITSVLNSSWVDLGGNTANEKVLCAIGLIEAFCRERVIPPTSNSFNTSVTYHIMVEDLDPDDLGNIQLINKPLLSLEGDLKVLGSYQLTFQTIPGHSEPRSMTDNGIYHSDSPFFQIALGHALLGTGKIYDHITRALRVAPITIAPEKRKEPLSSYMV
>T0851 CalS8, Micromonospora echinospora, 456 residues	SNAMPFLPDPGEPSPLKVVIAGAGYVGTCLAVTLAGRGAEVVAVDSDPGTVADLRAGRCRLPEPGLAGAVRDLAATGRLTASTSYDPVGAADVVIVTVGTPTDAGHEMVTDQLVAACEQIAPRLRAGQLVILKSTVSPGTTRTLVAPLLESGGLVHERDFGLAFCPERLAEGVALAQVRTLPVVVGGCGPRSAAAAERFWRSALGVDVRQVPSAESAEVVKLATNWWIDANVAIANELARYCAVLGVDVLDVIGAANTLPKGSSMVNLLLPGVGVGGSCLTKDPWMAWRDGRDRGVPLRTVETARAVNDDMPRHTAAVIADELVKLGRDRNDTTIAVLGAAFKNDTGDVRNTPVRGVVAALRDSGFRVRIFDPLADPAEIVARFGTAPAASLDEAVSGAGCLAFLAGHRQFHELDFGALAERVDEPCLVFDGRMHLPPARIRELHRFGFAYRGIGR
>T0852 APC103154, , 414 residues	MKKYLTIVIALVTLQSAFSQVISETFSSGRLNRKQKIGIYKPEKYTDRQAYPLIVVLNAETLMEPVVSMVRYYEQFGEMPKCIVVGVYEPKQEDVTVVEEVGRPINESARFFEFVSAELVPYIQGKYPIADLKGVIASEEAGFLANYYMLAEKKPTFNMIVSLNPVALPRMGEEFSHALAAGVPNRLFYYMATADVENKVVYDKAIQFERAMRSAPVHESVEYHFVDFKGSSVNAAKLQGIAQALDMCFDIYKPIGGKEFKTQMETLETGIYEYLENKYNTIYKQLGVKKVPILNDVMATYTAINSSQDWESLKKLAKYVESNGYLKTAMPNFFLAEYYEKIGDDKKALKTYQKAYTEPNIDFITGDLINERITHLQATKRKSKHTKVIEPIEPTEEVAPAQEEQNPTDESNQN
>T0853 SP18371B, , 152 residues	GEEKMTNGQLWKKVKDSLIDSNIISGNENEEITVTYVNKTGYSSSVSAYGNNNDDFSSTPSNFSKLKEIDLKKDNVPSDDFNTTVSGEDSWKTLTSKLKEKGLVTDGQTVTIHCNDKSDNTKSSVSGKVGADLTSGNGTTFKKRFIDKITID
>T0854 FP7307A, Geobacter sulfurred, 212 residues	MAVSSNGGAIKAVIYDCDGVMFDSFEANLAFYQRIMEMMGRPRLSRDNEEQMRILHTYANREVLAHFFPSPGDWEEAVRCAGAIDYRELVPLMIMEEGFREALDTLKGRVGLGVCTNRSTSMDMVLRLFSLDSYFSIVMTASRVTNPKPHPEPLLKVLEHFGIGPREALFVGDSEVDRLSAEAAGVPFVAYKAPLPAAYRMEHHREIIDLLG
>T0855 SP18870A_t, , 119 residues	GHMKFTDQQIGVLAGLAISPEWLKQNIAANQLVYGIVKPSDTVPAGVDDYSYLVAADDQDGTIIFFKAEGQTVIIKYTSQRNTKLKAKALTLSQLKKEFYQTRSQKREVDDYVAGLRTE
>T0856 HERC1, Homo sapiens, 159 residues	GFDPEKAQCCLVENGQILTHGSGGKGYGLASTGVTSGCYQWKFYIVKENRGNEGTCVGVSRWPVHDFNHRTTSDMWLYRAYSGNLYHNGEQTLTLSSFTQGDFITCVLDMEARTISFGKNGEEPKLAFEDVDAAELYPCVMFYSSNPGEKVKICDMQMR
>T0857 GS13171A, , 105 residues	GHMGSPVSYYFSYADGGTSHTEYPDDSSAGSFILDITSYKKTGNSTKALSWNASGDSWIHVNGSSVSYDENPAKERRTGLVTLKQDESGKTLSLKIVQPGKTSID
>T0858 BT3312, , 494 residues	MGSSHHHHHHSSGPQQGLRSNSDDAEKPVVPVPTGDVAIYTTTSSLTRDLTRDAVNFSPKDNLAPTTITLNPAEQYQTMDGFGAAITGSTCYNLLLMKPADRHAFLTETFSDKDGFGFSYIRISIGCSDFSLSEYTCCDTKGIENFALQSEEKDYILPILKEILAINPSIKVIAAPWTCPKWMKVKSLTDRTPLDSWTNGQLNPDYYQDYATYFVKWIQAFKAEGIDIYAVTPQNEPLNRGNSASLYMEWEEQRDFVKTALGPQMKAAGLSTKIYAFDHNYNYDNIESQKNYPGKIYEDAAASQYLAGAAYHNYGGNREELLNIHQAYPEKELLFTETSIGTWNSGRDLSKRLMEDMEEVALGTINNWCKGVIVWNLMLDNDRGPNREGGCQTCYGAVDINNSDYKTIIRNSHYYIIAHLSSVVKPGAVRIATTGYTDNGITCSAFENTDGTYAFVLINNNEKSKKITVSDGQRHFAYDVPGKSVTSYRWAKSK
>T0859	GSMANKPMQPITSTANKIVWSDPTRLSTTFSASLLRQRVKVGIAELNNVSGQYVSVYKRPAPKPEGGADAGVIMPNENQSIRTVISGSAENLATLKAEWETHKRNVDTLFASGNAGLGFLDPTAAIVSSDTTA
>T0860	VSYSDGHFLTKSGGVINFRKTRVTSITITILGNYGLRVVNGELQNTPLTFKGADFKSSTLKDELLIPLEGAVQLNTAPSTALCIFITTDHVYRELCMMQFLTDVDKTPFLVVLRSESKHETIQYMHIVTVHPFLSLT
>T0861	MGKIFEDNSLTIGHTPLVRLNRIGNGRILAKVESRNPSFSVKCRIGANMIWDAEKRGVLKPGVELVEPTSGNTGIALAYVAAARGYKLTLTMPETMSIERRKLLKALGANLVLTEGAKGMKGAIQKAEEIVASNPEKYLLLQQFSNPANPEIHEKTTGPEIWEDTDGQVDVFIAGVGTGGTLTGVSRYIKGTKGKTDLISVAVEPTDSPVIAQALAGEEIKPGPHKIQGIGAGFIPANLDLKLVDKVIGITNEEAISTARRLMEEEGILAGISSGAAVAAALKLQEDESFTNKNIVVILPSSGERYLSTALFADLFTEKELQQ
>T0862	MAKSHHHHHHTSVENNALSLVARGCAVAAPCRTKVAEQLLEIGAKAGMAGLAGAAVKDMADRMTSDELEHLITLQMMGNDEITTKYLSSLHDKYGSGAASNPNIGKDLTDAEKVELGGSGSGTGTPPPSENDPKQQNEKTVDKLNQKQESAIKKIDNTIKNALKDHDIIGTLKDMDGKPVPKENGGYWDAMQEMQNTLRGLRNHADTLKNVNNPEAQAAYGRATDAINKIESALKGYGI
>T0863	MSAETVNNYDYSDWYENAAPTKAPVEVIPPCDPTADEGLFHICIAAISLVVMLVLAILARRQKLSDNQRGLTGLLSPVNFLDHTQHKGLAVAVYGVLFCKLVGMVLSHHPLPFTKEVANKEFWMILALLYYPTLYYPLLACGTLHNKVGYVLGSLLSWTHFGILVWQKVDCPKTPQIYKYYALFGSLPQIACLAFLSFQYPLLLFKGLQNTETANASEDLSSSYYRDYVKKILKKKKPTKISSSTSKPKLFDRLRDAVKSYIYTPEDVFRFPLKLAISVVVAFIALYQMALLLISGVLPTLHIVRRGVDENIAFLLAGFNIILSNDRQEVVRIVVYYLWCVEICYVSAVTLSCLVNLLMLMRSMVLHRSNLKGLYRGDSLNVFNCHRSIRPSRPALVCWMGFTSYQAAFLCLGMAIQTLVFFICILFAVFLIIIPILWGTNLMLFHIIGNLWPFWLTLVLAALIQHVASRFLFIRKDGGTRDLNNRGSLFLLSYILFLVNVMIGVVLGIWRVVITALFNIVHLGRLDISLLNRNVEAFDPGYRCYSHYLKIEVSQSHPVMKAFCGLLLQSSGQDGLSAQRIRDAEEGIQLVQQEKKQNKVSNAKRARAHWQLLYTLVNNPSLVGSRKHFQCQSSESFINGALSRTSKEGSKKDGSVKEPNKEAESAAASN
>T0864	GHMASGPWKLTASKTHIMKSADVEKLADELHMPSLPEMMFGDNVLRIQHGSGFGIEFNATDALRCVNNYQGMLKVACAEEWQESRTEGEHSKEVIKPYDWTYTTDYKGTLLGESLKLKVVPTTDHIDTEKLKAREQIKFFEEVLLFEDELHDHGVSSLSVKIRVMPSSFFLLLRFFLRIDGVLIRMNDTRLYHEADKTYMLREYTSRESKISSLMHVPPSLFTEPNEISQYLPIKEAVCEKLIFPE
>T0865	GHMEGKPKMEPAASSQAAVEELRTQVRELRSIIETMKDQQKREIKQLLSELDEEKKIRLRLQMEVNDIKKALQSK
>T0866	MQTKKNEIWVGIFLLAALLAALFVCLKAANVTSIRTEPTYTLYATFDNIGGLKARSPVSIGGVVVGRVADITLDPKTYLPRVTLEIEQRYNHIPDTSSLSIRTSGLLGEQYLALNVGFEDPELGTAILKDGDTIQDTKSAMVLEDLIGQFLYGSKGDDNKNSGDAPAAAPGNNETTEPVGTTK
>T0867	QITNFAEQLVNEEGVTFTLQAKSEHAAPFTKLSLYLYCGAALTQTFRARGSEQLISFLESHPKKRWLVNFPLGMGIVSTEKTEVLIEVSKTIPEIGSGSSFCFI
>T0868	MGASSGSNISASNGSSSPTTIVASNPVDLNAFDRLNVVDPAVGKFRPGEAGAAAELENYLGGTLQRAPQGSSVDFVFSSGPNNGKTVDFMLTPDTVAQAAKINQFFDKNLNNFMNTLSDHAAAADFVPLASRFLSEANKTLLVKAIGNLPQKLQAKIILIK
>T0869	KMAGSIVISKEVRVPVSTSQFDYLVSRIGDQFHSSDMWIKDEVYLPMEEGGMSFISTESLNSSGLSIFLATVMRARAASQAEESFPLYENVWNQLVEKLRQDARLGVSGNTSLEHHHHHH
>T0870	MITLRKLIGNINMTKEPEQQSPLELWFERIIDVPLEKLTVEDLCRAIRQNLCIDQLMPRVLEVLTKEPLAGEYYDGELIAALSTIKGEDLKDQKSTFTQIRQLINQLEPSDINDDLRKDILKINQIIVTSLEHHHHHH
>T0871	MGSSHHHHHHSSGLVPRGSHMASMTGGQQMGRGSEFMSDQPWLHRLDPAEAAEIDDALDVLLKSGKPNFAASPADFPLPTLGPRLRGIVDSIENEPGFALVRGVPVGDKSEDEVRRLYWGLGMYIGVPMIQNNNDSSMVDIRDERRAGKLRVHKSNQHIGFHIDSTDVVTLLCRRAASQGGTSLVVSAEAVRREMSWECPELLSALYEPLPFADVASPDDERPDVFLSPVFGRHEGLTTTRFYIRRVLRSQDNPDAPRLTERQLEAINKVEEIAARPGLVTPMQFEPGDLQMINNHLVLHGRTAFASEEPGEGRHLLRMWFSVPSSRSLPPGYEAAWGTREGGTLRGAGPRWQLQGEFGEFQRRQAEELGVAIPA
>T0872	VTVDDLVEGIAFSITHDSENPNIVYLKSLMPSSYQVCWQHPQGRSQEREVTLQMPFEGKYEVTFGVQTRGGIVYGNPATFTIDSFCADFVN
>T0873	MGSSHHHHHHSQDPNSMKRLKDLREYLAVLEAHQDVREIDEPVDPHLEAGAAARWTYENRGPALMLNDLTGTGRFCRILAAPAGLSTIPGSPLARVALSLGLDVSATAHEIVDSLAAARTREPVAPVVVDSAPCQDNVLLGDDANLDRFPAPLLHEGDGGPYLNTWGTIIVSTPDGSFTNWAIARVMKIDGKRMTGTFIPTQHLGQIRKLWDNLGQPMPFAIVQGTEPGIPFVASMPLPDGIEEVGFLGAYFGEPLELVRAKTVDLLVPASAEIVIEGHVMPGRTAVEGPMGEYAGYQPRHTSMQPEYVVDAITYRDDPIWPISVAGEPVDETHTAWGLVTAAEALALLRAAKLPVATAWMPFEAAAHWLIVCLTEDWRERMPGLSRDGICLRISQVLAATRIEAMMTRVFVLDDDVDPSDQTELAWAIATRVSPAHGRLVRHGMINPLAGCYSAEERRLGYGPKAVLNGLLPPMAERSRRSSFRHTYPEPVRQRVIELLA
>T0874	SPYGQQPQNRMMKLAYLDRGFYKHYGIIVGDHVYQLDSDDIFKTALTGKAKFTKTKLTSDWVIEEECELDYFRIKYLESAVDSEHIFSVDKNCETIAKDIFGTHTLSQHQAIGLVGTILLTAGLMSTIK
>T0875	PDIELVYKNRGFYKHYGIRIGDQIYHLNSQDILTTAITGKSEFIKEQDDGNWTHAMTAPLDYFTEKYVNSMVGSKHIFSCTTNCETIARDIFPGQSGISQSKALGIVGLILLSASLLSLLAV
>T0876	GAASATPDVDPDDRVYIVRAQRPTYVHWAIRKVAPDGSAKQISLSRSGIQALVALEPPEGEPYLEILPSHWTLAELQLGNKWEYSATNNCTHFVSSITGESLPNTGFSLALGIGALTAIAASAAVAVKALPGIRRQ
>T0877	PYVPMPCMINDTHFLLRGPFEASWAIKLEITDVTTLVVDTDNVANPTNISKCFANNQDERLLGFTMEWFLSGLEHDHHFTPQIICGNVSKGEVNAQVNITMEDHCSQVFLKMRRIFGVFKNPCTSHGKQNVLISVSNWTNQC
>T0878	MAHHHHHHMAISPRDEQNRSVDLWFAYKVPKLTKDADSDSASGYEYVYYDRQVGAVQKSPNLMNDPKGALFYTLDSVFGDPGDTTGWILYNDEMPADANRSNNATLGHTKGVIAFDIASSSALWLLHSWPKYASPSVPGVPTPLYGQTFLCLSLDLATAGKLAAQMALHQQPQVYLPRTGGLDHTSPLYALTQPLNASAPGDSDSLDFKTRGGVPFKVIAKNRKWGKDFWNDLVGPTLKADMYVETWIRGKIPPVLDSDGVHKTYDIKFIDLRKLGAPWAWPETQDHAKWGITTTDNWVCVGDINRMVTQEKRGGGTIAFQDPKLWKALCETDLIIPPPGKTDAQARAMIRKTHEPAE
>T0879	SVYDPAATADTVNPGNKIIYLTFDDGPGKYTQGLLDVLDKYNVKATFFVTNTHPDYQNMIAEEAKRGHTVAIHSASHKYNQIYTSEQAFFDDLEQMNSIIKAQTGNDASIIRFPGGSSNTVSKDYCPGIMTQLVNDVTARGLLYCDWNVSSGDANPKPISTEQVVQNVISGVQSHNVSVVLQHDIKEFSVNAVEQIIQWGQANGYTFLPLTTSSPMSHHRVNN
>T0880	FFTAAPLSYNTGNSTISLDYRSPQLRVSGGALALTSPVFVYQTPFNTPMRLRNGTYNEYADAHIQMVRFGTTVLFNIDVTGETNATGTQTWELQFDGTLGSCLTGRMQVMGGTGEELDVTPTFILPTSDKSVYKQGFMPIVCSENGEFKQSTYCSYALTYRLGNFYITLKSTTSGCKPIFQMSFMYESQIGIV
>T0881	QNYVFTSGNGIGGNGFTARVMAKVGTSYITFPCAYDAKLISFNGTVQGNITIKVRSRDISGIPLDQQTTNPTFTFWLCRDTTNSSLKNFSNCSNNQFTPNKTTVISKTNPNGLNAWVTSTDQNWYLGNTSGDTIYGVPNGDGKLSGTYLYSVVFSVVQFYGTSMPRLAFTVNLTPTGANSNHLYVPDNNAAVTIGPVKFWYL
>T0882	SMTSRPKLRILNVSNKGDRVVECQLETHNRKMVTFKFDLDGDNPEEIATIMVNNDFILAIERESFVDQVREIIEKADEMLSEDVSVEPE
>T0883	MKKEKNDPTTPGTTTTVIPLQTTVQTPITLGSANNFAVIAGSSVTNTGATNITGDLGLSPGTSIGGFPPGILNGTLHINDAIANQAKLDITTAYNDAAARVASDMVTISGNIGGLTLTPGLYKSTSSLAVSSGDVTFDALGDPSAIFVIQIASTLTTTPGRKVLLSGGALASNIYWQVSSSASFGTTTSFKGTVIALESITFDTGATLEGRALARNGAVTMEGNTFVLPLEHHHHHH
>T0884	RGPSNGQSVLENSVQVKETSPRRVSVDPQTGEFVVFDRTLGDVYHGHVRAWKDLTSDMQNALVRGGYVDRKGNPK
>T0885	MTMRYQEPARIPNAEIDHVLASGNPEAIADACLSIAYYEDDWEWAFKRLKSVAFDLNRPDSLRSLAVTCVGHLARRIHDLDVAMAEEFLLSLGGDQAVASAASDALDDLRIFRMSD
>T0886	MGHHHHHHGGSENLYFQGNEDILKASATQSAVAGTYQIQVNSLATSSKIALQAIADPANAKFNSGTLNISVGDTKLPAITVDSSNNTLAGMRDAINQAGKEAGVSATIITDNSGSRLVLSSTKTGDGKDIKVEVSDDGSGGNTSLSQLAFDPATAPKLSDGAAAGYVTKAANGEITVDGLKRSIASNSVSDVIDGVSFDVKAVTEAGKPITLTVSRDDAGVKDNVKKFVEAYNTLTKFINEQTVVTKVGEDKNPVTGALLGDASVRALVNTMRSELIASNENGSVRNLAALGITTTKDGTLEIDEKKLDKAISADFEGVASYFTGDTGLAKRLGDKMKPYTDAQGI
>T0887	AQSLSNQTSAPAAAAPIDADKKAAIKDLLDAIDAPKLVSAIANSAEMQSKQLVPAILSDALSENKTLNDKQKQAAVPTLQKNAVPKLVDGAGKVFGTQQFTNDAMQAQYDAYAKYYSTSEIKDLTTFYKSPTGRKFIQVQDQVGRDVVNGLMQKYMPQAIKATRDQADKEVAAVKPGK
>T0888	EKIFVWKDGTAPTFNDWAILYKETRNVNMSFYEIKIGQQWVNKTGGTFTFNIPVTGDTDFYNFLLNCPLPMPFITTTGNSWMTANLGVHGYISADNPFTKMTLTINDVRNVIGPIYAMGYY
>T0889	MARELEGKVAAVTGAASGIGLASAEAMLAAGARVVMVDRDEAALKALCNKHGDTVIPLVVDLLDPEDCATLLPRVLEKACQLDILHANAGTYVGGDLVDADTMAIDRMLNLNVNVVMKNVHDVLPHMIERRTGDIIVTSSLAAHFPTPWEPVYASSKWAINCFVQTVRRQVFKHGIRVGSISPGPVVSALLADWPPEKLKEARDSGSLLEASDVAEVVMFMLTRPRGMTIRDVLMLPTNFDL
>T0890	EKVETVAGLGFKDKEAAEKTLKILKGRDPDYQKLAIKGLLGSAKRVLPSTKNEDKIKSIKEAMETFEDFLETFDREERSKQNMAYLSLDLIKNLSDKPSDALAAEFVECYDKVAKGNYKHLRTKFPKDDDSTSWDIVRNKKLLKLKETVKQNGEKLFDSDGKPTKVHLEMIYWAYSPNVDKLKAYCTKLEK
>T0891	ENMAVQSPKKHVFDAVIKAYKDNSDEESYATVYIKDPKLTIENGKRIITATLKDSDFFDYLKVEDSKEPGVFHDVKVLSEDKRKHGTKVIQFEVGELGKRYNMQMHILIPTLGYDKEFKIQFEVNMRTFV
>T0892	SPSINVALKAAFPSPPYLVELLETAASDNTTIYYSLLDRIAKGHFAEATTDKALYEKFLEVLRDDGHMDPEALSAFKLALSLRTATPRVEAHYQYYTATVEPSLSGTQEGCDQWFLIDGEQYCSPTLDTSHGKVKGEDQLRTLPFDRKFGVGSRDVILYADITSKSFAPFHEVAMDLAKKGKASYRVRYRRSP
>T0893	LSQAQKMQAIGQLAGGVAHDFNNLLTAIQLRLDQLLHRHPVGDPSYEGLNEIRQTGVRAADLVRKLLAFSRKQTVQREVLDLGELISEFEVLLRRLLREDVKLITDYGRDLPQVRADKSQLETAVMNLAVNARDAVRAAKGGGVVRIRTARLTRDEAIQLGFPAADGDTAFIEVSDDGPGIPPDVMGKIFDPFFTTKPVGEGTGLGLATVYGIVKQSDGWIHVHSRPNEGAAFRIFLPVYEA
>T0894	MVDNNYLSVSEKTELEIAKQTLKNSKNPAEREKAQQKYDALLEKDIASDKEVIAACGNGNAGSSACASARLKVIASKEGYEDGPYNSKYSQQYADAYGQIVNLLDITSVDVQNQQQVKDAMVSYFMATLGVDQKTAQGYVETTQGLEIAAASMTPLFGQAVANKITALVDKANKYPSGIGFKINQPEHLAQLDGYSQKKGISGAHNADVFNKAVVDNGVKIISETPTGVRGITQVQYEIPTKDAAGNTTGNYKGNGAKPFEKTIYDPKIFTDEKMLQLGQEAAAIGYSNAIKNGLQAYDAKAGGVTFRVYIDQKTGIVSNFHPK
>T0895	MNKYLFELPYERSEPGWTIRSYFDLMYNENRFLDAVENIVNKESYILDGIYCNFPDMNSYDESEHFEGVEFAVGYPPDEDDIVIVSEETCFEYVRLACEKYLQLHPEDTEKVNKLLSKIPSAGHHHHHH
>T0896	MNGDYMKASLVGVAAAVLMSVLAGSPVSAQVADASAQVVSKSQLIVGKRYYISVDTLNVRSSNSTTANNVIGKLSKNDVVEVYDVLNEATPLVQVKIIKSTTVSPYISSDFFVSKDYLSERELTLPTSRYFVVQNIATEKTRIYERCTATPGCAHKMVMETDMVVGRPEEGDGQDDNAYKTWVGHSRISEWVKFYQDGKAFYPRWYTPGQNIKDIPDPVTDSMSLYMGARKWLRKNEQGKTSNYGAFGWYAAKLTPAGENGGVNYQWIHGTMGWGKDGSKPIEITRMKMINFFSNPGSHGCTRLENQAVAYMRHLLGPGTDIYRVYAREASREAAPFSRYRDSQRPLPWEWMLLTNGAAQSNGLTADAATIRAQGISAVPGVNLIERGVYQVDRYPTVMPLNYSKSAASGLSGDRYEIDKNLKKGQGSNFRGYFLVDEGRFVSYSHPNYNATGGAIRVGGMADFMDSVPALLQAGAGNYYPPAIIK
>T0897	MVVNNALNFDSTPTNAKKHQPQKPDKTALEKIIQGIMPAHAAGAMTNPQDKDAAIWISNIRNGITGPIVITSYGVYAAGWTAPLIGTAGKLAISTCMANPSGCTVMVTQAAEAGAGIATGAVTVGNAWEAPVGALSKAKAAKQAIPTQTVKELDGLLQESKNIGAVNTRINIANSTTRYTPMRQTGQPVSAGFEHVLEGHFHRPIANNRSVFTISPNELKVILQSNKVVSSPVSMTPDGQYMRTVDVGKVIGTTSIKEGGQPTTTIKVFTDKSGNLITTYPVKGN
>T0898	MSNFEKKYILELNDALSHLNHNSTSFDLLKVLISWLSNDIVIDKFKILGYDFSKYIEMNPDDYPVEKSILNREEIIYLKNNIYRKISSGNFKFQYFVQYIRDILEYLFIEHIERVCPYCEWGEMQKLEEQNTHETVYLCTQCGCAFYNDNSQFLLKTPLTIPMKRDEFK
>T0899	MKQIIALCIYTSALMLVTGCSPESPGLMVQQDPIPETPVEIPQYEMPAQQEFKWITEDGGQSQLDFNPQVDILFVTDNSESMKSAQENLVRNLDRFTNGINKNAMIDYQIGVISTWDSSERFSATKKDKYGIGELRHIKDGKSQNYNKRFVTKKEKHLLASTLDLGVAPYAQGGPEDEEFFAPLTAALEKSGRGGVNEGFFREDAQLVVVFLTDADEFKQSRITAEQMARTLLDFKKGKANKLAVYGALVKASDSDQYKDWALRIHPKYNEQCFDMTQKTPKNNGTCTGFGPEKLEELIVRANEDKGAPDAIKSKYIVGIVNKNFGEDLARIGSDITKKTLAKEIFLTQRPRATADGSLQIRVRYGTPEQLNAGRGQVIPNKANGGWTYDPENNSVLLPGDIEYKYQDKARFAVDLIPLTLAQ
>T0900	MGAEEESTAILYPFTISGNDRNGNFTINFKGTPNSTNNGCIGYSYNGDWEKIEWEGSCDGNGNLVVEVPMSKIPAGVTSGEIQIWWHSGDLKMTDYKALEHHHHHH
>T0901	MKKDFQLLVVAAASSLLMACAQNVSFDLPETQDNFGQSITYNNKVDILWIVDNSTSMLKHQQRLSEQVPDLVSKLNTLKMDYHMAVVTTSMGGTSPDGGKFIGSPKYVTSKTPDLVNSLKNRMIVGEAGSNLERGLESMENALSANYLANEGKGFFRNDALLVVIALSDEDDFSKSSSSAGITYYTNLLDGIKEPWVDGSRSWVFNFIGVLSLTSQCKTFNDFASAGLSYMGLADTSGGVKESICSTNLSSAVGNIRSRIYQILTDFKLSKVPLEESITVSINGVSIPRDTTNGWDYLAASNVIRFYGTAVPAADASIKVDFKPKDAN
>T0902	MADDFLSVGKLELPGSMIGAVRDRAIDSGVLAKLSPEQPTIFGPVKGAVFSGVPRAKIVGEGEVKPSASVDVSAFTAQPIKVVTQQRVSDEFMWADADYRLGVLQDLISPALGASIGRAVDLIAFHGIDPATGKAASAVHTSLNKTKNIVDATDSATADLVKAVGLIAGAGLQVPNGVALDPAFSFALSTEVYPKGSPLAGQPMYPAAGFAGLDNWRGLNVGASSTVSGAPEMSPASGVKAIVGDFSRVHWGFQRNFPIELIEYGDPDQTGRDLKGHNEVMVRAEAVLYVAIESLDSFAVVKEKAAPKPNPPAEN
>T0903	SHDGNSQQGSGSDGGSSMCLELALEGERLCKAGDCRAGVAFFQAAIQAGTEDLRTLSAIYSQLGNAYFYLGDYNKAMQYHKHDLTLAKSMNDRLGEAKSSGNLGNTLKVMGRFDEAAICCERHLTLARQLGDRLSEGRALYNLGNVYHAKGKHLGQRNPGKFGDDVKEALTRAVEFYQENLKLMRDLGDRGAQGRACGNLGNTYYLLGDFQAAIEHHQERLRIAREFGDRAAERRANSNLGNSHIFLGQFEDAAEHYKRTLALAVELGEREVEAQSCYSLGNTYTLLHEFNTAIEYHNRHLAIAQELGDRIGEARACWSLGNAHSAIGGHERALKYAEQHLQLAKELHDPVGESTARVNISDLRKLLGMPDSEPSPTEEEAR
>T0904	SLRFTASTSTPKSGSKIAKRGKKHPEPVASWMSEQRWAGEPEVMCTLQHKSIAQEAYKNYTITTSAVCKLVRQLQQQALSLQVHFERSERVLSGLQASSLPEALAGATQLLSHLDDFTATLERRGVFFNDAKIERRRYEQHLEQIRTVSKDTRYSLERQHYINLESLLDDVQLLKRHTLITLRLIFERLVRVLVISIEQSQCDLLLRANINMVATLMNIDYDGFRSLSDAFVQNEAVRTLLVVVLDHKQSSVRALALRALATLCCAPQAINQLGSCGGIEIVRDILQVESAGERGAIERREAVSLLAQITAAWHGSEHRVPGLRDCAESLVAGLAALLQPE
>T0905	MKKTVASKALMMASAVALVAGCSKGTGSYSLLNDAEDYKQQAVFIPKQIDILWVIDNSGSMKTSQDNLAANFQSFISRFQQYNYDFHMAVTTTEAWEKQFNSASEKARIKDGAVLQTNPKIETHSGVFIMDKNTANLGDVFSTNAKQGTLGNGDERAFSSFKEALLEPQNAGFRRSEAFLAVIIVSDEEDFSSSSAAFNESYNNANLHTVQSYVDFLDGYVGSRNYSVSTITVPDDACKTSLSTDGFARKISTRLPELATLTAGVKGSLCSNFGSTLELISDSIIQLSSVFKLNREPQEDTIVITVNGVSVPNDAVNGWTYDASNLTITFHGSSVPAADANITIDFYPKSIKL
>T0906	MKVTLSVLKADIGSVGGHTLPSRKVLAKVEEVVREEVGRLLLDAYVFHIGDDIVLLLSHTRGVRNQEVHALAWKAFREGTEVAKAEGLYGAGQDLLKDAFTGNLHGLGPQVAEMEFTERPAEPFMVLAADKTEPGAFNLPLYLAFADPMYSSGLLLSPELRPGFRFRIMDLAQTERDSYIELDAPERLYDIATLLRDSHRFAIESIWSRKHGEQAAVVSTTRLRNIAGRYVGKDDPVAIVRTQKIFPATEEFGPVFALAPYVAGDTRGSHHMPLMPVRANTPASTFFCVPMVCGLAFSLREGRLSEPVDLFADPVWEAVRAKVVEKAQEMRRQGFYGPAMLPMEELEYTGIAERLKALEREFS
>T0907	MGHHHHHHSSGVDLGTENLYFQSVNSITAQVIPQSQIVMSGDTYKANIVLSSVDTTQRPDVFVNGKLLSPENMGLFTATAGAPGTYPVKGYIEMMGNDGVKIRRDFESEYFVTEPMASVAPTMMNVLYAGIDNPINIAVPGVAQQNVSATINNGTLTRRGNLWIARPTKVGSEAIISVTAQSGGRTIQMAKTTLRVRALPDPLPYIEYKDVQGNTKRFKGGRLGKREILAAGGIKAALDDDLLEVNYTVVKFQLVFYDSMGNSIPEVSDGASFSERQKRQIQNLGKGKRFYVTEVIARGPDGIERKIPAIEVIVN
>T0908	MQVQLVESGGGLVQAGGSLRLSCAASGRTFSSYVMGWFRQAPGKEREFVTAISWSGGSIHYADSVKGRFTISRDNAKNTVYLQMNSLKPEDTAVYTCVAGFAGYGSFTSRSARDSDKYDYWGQGTKVTVSSHHHHHH
>T0909	LLPGQSPDEAFARNSVVFLVPGAEYNWKNVVIRKPVWIYGERCHGEDFRPRAIIHIMGDLDNPMDVRIQDLTFIGGDSPDRLVPFSAVLTNQMALWCIDPRITIRGCSFYNFGGAAIYLERSERDTGFRFGRGQVMITDCRFRGCRIGIANGGSVEYGLASQNNFSDCQICFNVVGGNWTRSGNVASNCRCMYLHTQGMWYEGAAGNFNPAHGSFTSNTLNHCDYGGNLWPTEFQLPDRVINLAGFYFDNAAARLPNFSGNSQWYGDMKLINFLPDSTFVINGGALYGGPGDTGVIAVATALAAKVFVIGCQGNAGQQIVNVPAANIIPEVGTRKDDATQ
>T0910	GLDDVSNKAYEDAEAKAKYEAEAAFFANLKLSDFNIIDTLGVGGFGRVELVQLKSEESKTFAMKILKKRHIVDTRQQEHIRSEKQIMQGAHSDFIVRLYRTFKDSKYLYMLMEACLGGELWTILRDRGSFEDSTTRFYTACVVEAFAYLHSKGIIYRDLKPENLILDHRGYAKLVDFGFAKKIGFGKKTWTFCGTPEYVAPEIILNKGHDISADYWSLGILMYELLTGSPPFSGPDPMKTYNIILRGIDMIEFPKKIAKNAANLIKKLCRDNPSERLGNLKNGVKDIQKHKWFEGFNWEGLRKGTLTPPIIPSVASPTDTSNFDSFPEDNDEPPPDDNSGWDIDF
>T0911	MVSGFAMPKIWRKLAMDIPVNAAKPGRRRYLTLVMIFITVVICYVDRANLAVASAHIQEEFGITKAEMGYVFSAFAWLYTLCQIPGGWFLDRVGSRVTYFIAIFGWSVATLFQGFATGLMSLIGLRAITGIFEAPAFPTNNRMVTSWFPEHERASAVGFYTSGQFVGLAFLTPLLIWIQEMLSWHWVFIVTGGIGIIWSLIWFKVYQPPRLTKGISKAELDYIRDGGGLVDGDAPVKKEARQPLTAKDWKLVFHRKLIGVYLGQFAVASTLWFFLTWFPNYLTQEKGITALKAGFMTTVPFLAAFVGVLLSGWVADLLVRKGFSLGFARKTPIICGLLISTCIMGANYTNDPMMIMCLMALAFFGNGFASITWSLVSSLAPMRLIGLTGGVFNFAGGLGGITVPLVVGYLAQGYGFAPALVYISAVALIGALSYILLVGDVKRVG
>T0912	MGSSHHHHHHSSGPQQGLRHLLSAGEIWISPQGNDLNDGTRPSPKATLTSALRQAREWRRTDDERVRGGITICMEGGTYALYEPVFIRPEDSGTEDSPTVIRPVADEKVVLSGGIRIGGWKKQGKLWVADVPMFNGRPLDFRQLWVNGKKAVRARDVEDFEKMNRICSVDEKNEILYVPAVAIRRLVDGKGALKAKYAEMVLHQMWCVANLRIRSVELAGDSAAIRFHQPESRIQFEHPWPRPMVTTDGHNSAFYLTNARELLDVAGEWYHDIDARKVYYYPREGEKLQDAGTEVIVPAIETLIQVKGTFDRPVSHIRFEKITFSHTTWMRPSEKGHVPLQAGMYLTDGYRIDPKMERDYLNHPLDNQGWLGRPAAAVSVAAANQIDFERCRFDHLGSTGLDYEEAVQGGVVRGCLFRDIAGNGLVVGSFSPAAHETHLPYDPTDLREVCAHQQISNCYFTEVGNEDWGCLAILAGYVKDINIEHNEICEVPYSGISLGWGWTQTVNCMRNNRVHANLIHHYAKHMYDVAGVYTLGSQPKSYVTENCVHSIYKPGYVHDPNHWFYLYTDEGSSFITVRDNWTEGEKYLQNANGPGNVWENNGPQVDTVIRERAGLEAEYRDLKK
>T0913	MHHHHHHMTTVDKRPSSRGYGDWRLSDIPQYKDGISTYEFVRATHEADYRTHQAEPVAGRTFGFNGIGRLTEVALHMPTKYTLHDQSSQYKESPSFFQGLMGVPDRGPVDLAAFQRETEELATAFENNGIKVHWVDYPEEPANPYGPLMGHVFLSWGSIWRGGSVISRFGFLPGMVGVSEYLAKWAWNTLNIPPLVAITEGAMEPGACNMIADEVLVTCLSASYDQRGTDQLVAAISKTSGTEEFHNLQLRPAVEGFFNKATGACAHPDININAIDVGKLVVSPAALDWDARTWLYDNNFELIEADPDEQREFLAPCNVLLLEPGKVIAHADCHKTNQKIRDAGVEVIEVTGTEIRKACGGIKCRVMQINREPGPTLADVRNRVWR
>T0914	VENNYLSVSEKTELEIAKQKLKNSKDPAEREKAQQKYDALLEKDISSDKAVITACSNGQAASAACAGERLKVIAAKGGYETGHYNNQVSDMYPDAYGQIVNLLNITSVDAQNQQQVKDAMVNYAMVQFGVDRATAQAYVETYDGMKVVAASMAPVIGAAAASKIEVLAGKQRLSNSFEVSSLPDANGKNHITAVKGDAKIPVDKIELYMRGKASGDLDSLQAEYNSLKDARISSQKEFAKDPNNAKRMEVLEKQIHNIERSQDMARVLEQAGIVNTASNNSMIMDKLLDSAQGATSANRKTSVVVSGPNGNVRIYATWTILPDGTKRLSTVNTGTFK
>T0915	MINVNSTAKDIEGLESYLANGYVEADSFNDPEDDALECLSNLLVKDSRGGLSFCKKILKSNNIDGVFIKGSALNFLLLSEQWSYAFEYLTSNADNITLAELEKALFYFYCAKNETDPYPVPEGLFKKLMKRYEELKNDPDAKFYHLHETYNDFSKAYPLNN
>T0916	SRNMKEKLEDMESVLKDLTEEKRKDVLNSLAKCLGKEDIRQDLEQRVSEVLISRELHMEDSDKPLLSSLFNAAGVLVEARAKAILDFLDALLELSEEQQFVAEALEKGTLPLLKDQVKSVMEQNWDELASSPPDMDYDPEARILCALYVVVSILLELAEGPTSVSS
>T0917	MHHHHHHMRMEFRHNLPSSDIIFGSGTLEKIGEETKKWGDKAILVTGKSNMKKLGFLADAIDYLESAGVETVHYGEIEPNPTTTVVDEGAEIVLEEGCDVVVALGGGSSMDAAKGIAMVAGHSAEERDISVWDFAPEGDKETKPITEKTLPVIAATSTSGTGSHVTPYAVITNPETKGKPGFGNKHSFPKVSIVDIDILKEMPPRLTAITGYDVFSHVSENLTAKGDHPTADPLAIRAIEYVTEYLLRAVEDGEDIKAREKMAVADTYAGLSNTISGTTLRHAMAHPISGYYPDISHGQALASISVPIMEHNIENGDEKTWERYSRIAVALDASKPVDNTRQAASKAVDGLKNLLRSLDLDKPLSELGVEEEKIPEMTEGAFIYMGGGIEANPVDVSKEDVKEIFRKSL
>T0918	MESNNGEAKIQKVKNWSPVWIFPIVTALIGAWVLFYHYSHQGPEVTLITANAEGIEGGKTTIKSRSVDVGVVESATLADDLTHVEIKARLNSGMEKLLHKDTVFWVVKPQIGREGISGLGTLLSGVYIELQPGAKGSKMDKYDLLDSPPLAPPDAKGIRVILDSKKAGQLSPGDPVLFRGYRVGSVETSTFDTQKRNISYQLFINAPYDRLVTNNVRFWKDSGIAVDLTSAGMRVEMGSLTTLLSGGVSFDVPEGLDLGQPVAPKTAFVLYDDQKSIQDSLYTDHIDYLMFFKDSVRGLQPGAPVEFRGIRLGTVSKVPFFAPNMRQTFNDDYRIPVLIRIEPERLKMQLGENADVVEHLGELLKRGLRGSLKTGNLVTGALYVDLDFYPNTPAITGIREFNGYQIIPTVSGGLAQIQQRLMEALDKINKLPLNPMIEQATSTLSESQRTMKNLQTTLDSMNKILASQSMQQLPTDMQSTLRELNRSMQGFQPGSAAYNKMVADMQRLDQVLRELQPVLKTLNEKSNALVFEAKDKKDPEPKRAKQ
>T0919	SRSVTVVGHSSFCTSDVVMSSTELNRLLGTDIYNFARGGASDVEVAMMSQEAITRQYAPVGGSSIPASGSVALTPTEVGIFWNGATGKCIIFGGIDGTFSTTLVNAGTGETQLVFTRDSAGSAVSSVSTTATFAMRPYTRFNTNTIPAGRRRKHSSLHRDDIYIVWGGRNSTDYTRYVSELHTMVANMHTQRRRFVICPEFPYDTETTGTTGATNLAALNNNLKADFPDNYCQISGGVDLLQNFKSKYNPAYAGDVTDIANGITPRSLREDNLHPSETTLQPNGLYIGAKVNADFIAQFIKSKGWG
>T0920	KPVVGVILPFSSAFEDIAVEQQRAVELALAESGSAFEIVFKDGGADVDTAVQAFQDLVRSQENLAAVVSCSSWASSAIHPLAAEKDIFHVAIGSAALKRTEPGHTIRLTVGVQQEQEQLAAYLTDFERIAVLAMDNNLGSSWIRMLEDRFPKQVVAAQEYNPQQMDIAAQLATIKARDSEALVLISAGEAATIAKQARQAGIKAQLVGTRPIQRAEVLAASAFTNGLVYTYPSYNQDHPFMSAFTDRYGLEPGFFGVEAYDLCTTLSRALEQGRQTPKALFEWYAGNTFTGALGKVTFANDGDASYPYIFKKVTESGFRVAEFQFPMLLTQTAQELNAIFKDMDRSVAAAAEQLSTTGLRGDRASAILETLFNENQYAYNCVTVDATGTIVNVAPKQYSSVIGEDISGQEQIIRLHETHQPVLSQAIKMVEGFVGIDLEHPVFDQDGGFIGSVSVLTQPDFFGSIISRKVHNFPVEIFVLQRDGTTIYDVNAEEIGKNAFADPIYDAFPSLKRIARKMVSQAEGEGTYRFQDRHMEHAVAKQLLWTSIGLHGTNYRLALTYGAGEIED
>T0921	MPVANADVVFDFQNYTAKAGDEVTVDVLVDSKNKPISAMDVKFKVDSPLTIEEIDKESLAFNTTVMTNMAILGANFKSLDDKGEPLVPKDGAAVFTLYVNVPANTPDGTYYVGFNGKNEVHKSNDGSQFTVASKNGAITVGTPNEEGLE
>T0922	MGSSHHHHHHSSGLVPRGSHMASVQKFPGDANCDGIVDISDAVLIMQTMANPSKYQMTDKGRINADVTGNSDGVTVLDAQFIQSYCLGLVELPPVE
>T0923	MGSSHHHHHHSSGLVPRGSHMASESNDAVQTTATAQAESSSKITLDDLLYIPANKTVSDWNQLVWAKLATRTQRDGTFNLTELAKEAVEHAGQFKDVADYALNELIIPNGVKYQITDNNDVVITGHISEPDFNRNLSLTSGNALAIQAENYKAPNLTKIDFSDISVEGDFKITFETSKLGAGTEVPIKFEYKTTADNKVYAAGQLFDLALDTMAKVKAKGDAALEKEIPAQFVDKAKADYAEKIKNVTDKIEKAKRNFEKALKAEKSGEYANVAGVIAKANTWLKNHNINKQIPATATDIAAKSIVTKAYDQLLNDFSQEHDINITAADLGKFADSLENIKGSLAKAVANGEATFKDAEQAEVKAYVESLGYAFVDSYKKVTAKVDFSGINTTDAGSVAVKIERVLVTN
>T0924	GSHMESLIAQKTEESADARRKAELLQNEAKTLLAQANSKLQLLEDLERKYEDNQKYLEDKAQELVRLEGEVRSLLKDISEKVAVYSTCL
>T0925	GEFEDLSRVNATVQETNDLLHNSTMTTLLAGRKMKDMEMQANLLLDRLKPLKTLEENLSRNLSEIKLLISRARKQAASIKVAVSADR
>T0926	GEFESLIAQKTEESADARRKAELLQNEAKTLLAQANSKLQLLEDLERKYEDNQKYLEDKAQELVRLEGEVRSLLKDISEKVAVYSTCL
>T0927	EGFDQLGQLDTVDLNKLNEIEGSLNKAKDEMKASDLDRKVSDLESEARKQEAAIMDYNRDIAEIIKDIHNLEDIKKTLPTGCFNTPSIEKP
>T0928	MGRRRAPELYRAPFPLYALQVDPSTGLLIAAGGGGAAKTGIKNGVHFLQLELINGRLSASLLHSHDTETRATMNLALAGDILAAGQDAHCQLLRFQAHQQQGNKAEKAGSKEQGPRQRKGAAPAEKKCGAETQHEGLELRVENLQAVQTDFSSDPLQKVVCFNHDNTLLATGGTDGYVRVWKVPSLEKVLEFKAHEGEIEDLALGPDGKLVTVGRDLKASVWQKDQLVTQLHWQENGPTFSSTPYRYQACRFGQVPDQPAGLRLFTVQIPHKRLRQPPPCYLTAWDGSNFLPLRTKSCGHEVVSCLDVSESGTFLGLGTVTGSVAIYIAFSLQCLYYVREAHGIVVTDVAFLPEKGRGPELLGSHETALFSVAVDSRCQLHLLPSRRS
>T0929	GSMANKPMQPITSTANKIVWSDPTRLSTTFSASLLRQRVKVGIAELNNVSGQYVSVYKRPAPKPEGGADAGVIMPNENQSIRTVISGSAENLATLKAEWETHKRNVDTLFASGNAGLGFLDPTAAIVSSDTTA
>T0930	MSAETVNNYDYSDWYENAAPTKAPVEVIPPCDPTADEGLFHICIAAISLVVMLVLAILARRQKLSDNQRGLTGLLSPVNFLDHTQHKGLAVAVYGVLFCKLVGMVLSHHPLPFTKEVANKEFWMILALLYYPTLYYPLLACGTLHNKVGYVLGSLLSWTHFGILVWQKVDCPKTPQIYKYYALFGSLPQIACLAFLSFQYPLLLFKGLQNTETANASEDLSSSYYRDYVKKILKKKKPTKISSSTSKPKLFDRLRDAVKSYIYTPEDVFRFPLKLAISVVVAFIALYQMALLLISGVLPTLHIVRRGVDENIAFLLAGFNIILSNDRQEVVRIVVYYLWCVEICYVSAVTLSCLVNLLMLMRSMVLHRSNLKGLYRGDSLNVFNCHRSIRPSRPALVCWMGFTSYQAAFLCLGMAIQTLVFFICILFAVFLIIIPILWGTNLMLFHIIGNLWPFWLTLVLAALIQHVASRFLFIRKDGGTRDLNNRGSLFLLSYILFLVNVMIGVVLGIWRVVITALFNIVHLGRLDISLLNRNVEAFDPGYRCYSHYLKIEVSQSHPVMKAFCGLLLQSSGQDGLSAQRIRDAEEGIQLVQQEKKQNKVSNAKRARAHWQLLYTLVNNPSLVGSRKHFQCQSSESFINGALSRTSKEGSKKDGSVKEPNKEAESAAASN
>T0931	AQSLSNQTSAPAAAAPIDADKKAAIKDLLDAIDAPKLVSAIANSAEMQSKQLVPAILSDALSENKTLNDKQKQAAVPTLQKNAVPKLVDGAGKVFGTQQFTNDAMQAQYDAYAKYYSTSEIKDLTTFYKSPTGRKFIQVQDQVGRDVVNGLMQKYMPQAIKATRDQADKEVAAVKPGK
>T0932	GHMASGPWKLTASKTHIMKSADVEKLADELHMPSLPEMMFGDNVLRIQHGSGFGIEFNATDALRCVNNYQGMLKVACAEEWQESRTEGEHSKEVIKPYDWTYTTDYKGTLLGESLKLKVVPTTDHIDTEKLKAREQIKFFEEVLLFEDELHDHGVSSLSVKIRVMPSSFFLLLRFFLRIDGVLIRMNDTRLYHEADKTYMLREYTSRESKISSLMHVPPSLFTEPNEISQYLPIKEAVCEKLIFPE
>T0933	MGHHHHHHGGSENLYFQGNEDILKASATQSAVAGTYQIQVNSLATSSKIALQAIADPANAKFNSGTLNISVGDTKLPAITVDSSNNTLAGMRDAINQAGKEAGVSATIITDNSGSRLVLSSTKTGDGKDIKVEVSDDGSGGNTSLSQLAFDPATAPKLSDGAAAGYVTKAANGEITVDGLKRSIASNSVSDVIDGVSFDVKAVTEAGKPITLTVSRDDAGVKDNVKKFVEAYNTLTKFINEQTVVTKVGEDKNPVTGALLGDASVRALVNTMRSELIASNENGSVRNLAALGITTTKDGTLEIDEKKLDKAISADFEGVASYFTGDTGLAKRLGDKMKPYTDAQGI
>T0934	MNGDYMKASLVGVAAAVLMSVLAGSPVSAQVADASAQVVSKSQLIVGKRYYISVDTLNVRSSNSTTANNVIGKLSKNDVVEVYDVLNEATPLVQVKIIKSTTVSPYISSDFFVSKDYLSERELTLPTSRYFVVQNIATEKTRIYERCTATPGCAHKMVMETDMVVGRPEEGDGQDDNAYKTWVGHSRISEWVKFYQDGKAFYPRWYTPGQNIKDIPDPVTDSMSLYMGARKWLRKNEQGKTSNYGAFGWYAAKLTPAGENGGVNYQWIHGTMGWGKDGSKPIEITRMKMINFFSNPGSHGCTRLENQAVAYMRHLLGPGTDIYRVYAREASREAAPFSRYRDSQRPLPWEWMLLTNGAAQSNGLTADAATIRAQGISAVPGVNLIERGVYQVDRYPTVMPLNYSKSAASGLSGDRYEIDKNLKKGQGSNFRGYFLVDEGRFVSYSHPNYNATGGAIRVGGMADFMDSVPALLQAGAGNYYPPAIIK
>T0935	ATMAFHPMLCRLELSVSAAPPASPIDATLLRSLITSVLNSSWVDLGGNTANEKVLCAIGLIEAFCRERVIPPTSNSFNTSVTYHIMVEDLDPDDLGNIQLINKPLLSLEGDLKVLGSYQLTFQTIPGHSEPRSMTDNGIYHSDSPFFQIALGHALLGTGKIYDHITRALRVAPITIA
>T0936	ADPIDVAMRQCLARRDRSSTAGQIQCMDEARQQWQGEVDAAYQRLVKTAPADARRGWQESQRRWLAWRKDEAHLVRAVYETTQGTMYAMASADMRLQPVRERALALRGAADRYAQPGGGKGAVHRVRPCMRDAACEHALFDMNRYYEKLRARMPADSRQTLVAAQREWAAFSDAMTPLVSEGERVDLIGARVATLKRFSETVNNR
>T0937	MTDDTRATQLLSGQTWADFCDTLKRSGEQILRTDAPDDPLTRAEGFRYLSRLMRIALEMHVEFADGAWPGFFSPSHETAKIGADNPDNLYQYARVDGRCEYRVTGRRGTVAYLSFGTQKGGYETDGKMLQTGFLDAKQLEIAPDGSVEIVLSATPRAGNWVRMEPDTNALLVRQTFLDRRTETPAQLKIERIDAQARPAPLDPLALQGGLMRAAQFVEQTSKLFADWAASYRPHVNALPPADQALCQSVGGDPNIYYYHSCWSLAADEALVIDVDTVPDCDFWNVQLNNYWMESLDYRHFDICVNKHSARPNADGGVTVIVAATRPGSANWLDTAGHRTGTICWRWVGAAQPVHPRTRVVKLAALKEAA
>T0938	MTSIPVDPAADLLRERAAHYAAEAALFLRDQALSTASHDLRSPLNAMHSWAYVLERQLASADPSLQRALAGIRTGIDQQVALIDDVLDAPRAETRTLAITAQPFALRPLLDDTLALVRFALADARQVSIDATLPDGEPSLSADRERVAQALWTMLTTAVEASAAGNRVTFACTRDGAQCVAHVTCGVSAAALADPALPHAFDAFARREMLRSRDAKRVAWVLALCQRVALAHGGTFTHAAFADGAVVTLSLAVPCKAAG
>T0939	MSEDLRVGLFPVRYLVGTGLPGAPQLVLDLMVDTVDHSVVGRAAVSQAVSPPLNFHADVWGSYVFRLGPPPRRDGSGAIVQISLQGNQGGPQSNSMITFYGELLLKGDGKTGVASYRYYSNGSWHEVENVPVKADPELVPIEPGPVIGQSSMSAIGSAAMYGVAIQSAAASGDLAHMRTLSAYARQQLESRDEIAAALSELKAEIAKLESRQ
>T0940	MLPETNQDEVQPNAPVALVTVEIRHPTTDSLTESANRELKHLLINDLPIERQAQDVSWGMTAPGGAPTPVADRFVRYVNRDNTTAASLKNQAIVVETTAYRSFEAFTDVVMRVVDARAQVSSIVGLERIGLRFVLEIRVPAGVDGRITWSNWIDEQLLGPQRFTPGGLVLTEWQGAAVYRELQPGKSLIVRYGPGMGQALDPNYHLRRITPAQTGPFFLLDIDSFWTPSGGSIPEYNRDALVSTFQDLYGPAQVVFQEMITSRLKDELLRQ
>T0941	MLKVLSELVYRKNTWRFLMLPMLHKHTIITAALLASLSLTACGKKKDVFSEPKKEATQTDSNKTSDTNDKLGGGLPDPADPNAGKPQPLPGKQPTTPTPPPPPKTPEAPQTSNPTPPPAPVPTTPPPVVGTRPAPAPGTNVIPGDYNEKDPNSLNRDNLTKRMTGGVTEDGLVYTSSSTDELLNYLRARNEKVGYETRRLNNEAAASVQSAKMSVDGLSGDVIITLKIKEGNDVKVYNVAGSSGEGAATPVRSVRAGNGERSTGARALEGTVKCVDLDGGCETTFARLKIGSSPTSAIINIVFRNSSADLFFKLPGNYSDNPEYLVLREFMRNTYLNENTQDKVKSVKMSSFEVVNGRSGFTVMMKGGNSELLAFAGPLLAPEAGTGVNIPLSRIAKDQEDTLDLISLNNTKLTYANWIGEARLVANNGLGQVRLALKMRKRATYAQDQFAITFMRKIKPIVDLTDDNLK
>T0942	MFRQLKKNLVATLIAAMTIGQVAPAFADSADTLPDMGTSAGSTLSIGQEMQMGDYYVRQLRGSAPLINDPLLTQYINSLGMRLVSHANSVKTPFHFFLINNDEINAFAFFGGNVVLHSALFRYSDNESQLASVMAHEISHVTQRHLARAMEDQQRSAPLTWVGALGSILLAMASPQAGMAALTGTLAGTRQGMISFTQQNEQEADRIGIQVLQRSGFDPQAMPTFLEKLLDQARYSSRPPEILLTHPLPESRLADARNRANQMRPMVVQSSEDFYLAKARTLGMYNSGRNQLTSDLLDEWAKGNVRQQRAAQYGRALQAMEANKYDEARKTLQPLLAAEPGNAWYLDLATDIDLGQNKANEAINRLKNARDLRTNPVLQLNLANAYLQGGQPQEAANILNRYTFNNKDDSNGWDLLAQAEAALNNRDQELAARAEGYALAGRLDQAISLLSSASSQVKLGSLQQARYDARIDQLRQLQERFKPYTKM
>T0943	ESFADMMKHGLTEADVGITKFVSSHQGFSGILKERYSDFVVHEIGKDGRISHLNDLSIPVDEEDPSEDIFTVLTAEEKQRLEELQLFKNKETSVAIEVIEDTKEKRTIIHQAIKSLFPGLETKTEDREGKKYIVAYHAAGKKALANPRKHSWPKSRGSYCHFVLYKENKDTMDAINVLSKYLRVKPNIFSYMGTKDKRAITVQEIAVLKITAQRLAHLNKCLMNFKLGNFSYQKNPLKLGELQGNHFTVVLRNITGTDDQVQQAMNSLKEIGFINYYGMQRFGTTAVPTYQVGRAILQNSWTEVMDLILKPRSGAEKGYLVKCREEWAKTKDPTAALRKLPVKRCVEGQLLRGLSKYGMKNIVSAFGIIPRNNRLMYIHSYQSYVWNNMVSKRIEDYGLKPVPGDLVLKGATATYIEEDDVNNYSIHDVVMPLPGFDVIYPKHKIQEAYREMLTADNLDIDNMRHKIRDYSLSGAYRKIIIRPQNVSWEVVAYDDPKIPLFNTDVDNLEGKTPPVFASEGKYRALKMDFSLPPSTYATMAIREVLKMDTSIKNQTQLNTTWLR
>T0944	MCGRTSCHLPRDVLTRACAYQDRRGQQRLPEWRDPDKYCPSYNKSPQSNSPVLLSRLHFEKDADSSERIIAPMRWGLVPSWFKESDPSKLQFNTTNCRSDTVMEKRSFKVPLGKGRRCVVLADGFYEWQRCQGTNQRQPYFIYFPQIKTEKSGSIGAADSPENWEKVWDNWRLLTMAGIFDCWEPPEGGDVLYSYTIITVDSCKGLSDIHHRMPAILDGEEAVSKWLDFGEVSTQEALKLIHPTENITFHAVSSVVNNSRNNTPECLAPVAENLYFQ
>T0945	SMWAFSELPMPLLINLIVSLLGFVATVTLIPAFRGHFIAARLCGQDLNKTSRQQIPESQGVISGAVFLIILFCFIPFPFLNCFVKEQCKAFPHHEFVALIGALLAICCMIFLGFADDVLNLRWRHKLLLPTAASLPLLMVYFTNFGNTTIVVPKPFRPILGLHLDLGILYYVYMGLLAVFCTNAINILAGINGLEAGQSLVISASIIVFNLVELEGDCRDDHVFSLYFMIPFFFTTLGLLYHNWYPSRVFVGDTFCYFAGMTFAGVGILGHFSKTMLLFFMPQVFNFLYSLPQLLHIIPCPRHRIPRLNIKTGKLEMSYSKFKTKSLSFLGTFILKVAESLQLVTVHQSETEDGEFTECNNMTLINLLLKVLGPIHERNLTLLLLLLQILGSAITFSIRYQLVRLFYDV
>T0946	SRSVTVVGHSFCTSDVMSTELNRLLGTDIYNFARGGASDVEVAMSQEAITRQYAPVGGSIPASGSVALTPTEVGIFWNGATGKCIFGGIDGTFSTTLVNAGTGETQLVFTRDSAGSAVSVSTTATFAMRPYTRFNTNTIPAGRKHSLHRDDIYIVWGGRNSTDYTRYVSELHTMVANMHTQRFVICPEFPYDTETTGTTGATNLAALNNNLKADFPDNYCQISGVDLLQNFKSKYNPAYAGDVTDIANGITPRSLREDNLHPSETLQPNGLYIGAKVNADFIAQFIKSKGWG
>T0947	MIAILESEVPCVTKDLMKKLIFPLIALTLVSLQSFAGSKATDRSYKYCDDMTQIDKLLDRSRESVERIQREGLNIERIVVSKDKRQLYLVSGDTLLRTYTVAFGWNFIGHKQFEGDGKTPEGIYSIDYKNPKSQFTKSLHVDYPNKADIAYAKSQGRSPGGDIMIHGLPSNPQKYERISKIHPYDWTLGCIAVTNKEIEEIYALVKERTLVEVCKISPTK
>T0948	SRNMKEKLEDMESVLKDLTEEKRKDVLNSLAKCLGKEDIRQDLEQRVSEVLISRELHMEDSDKPLLSSLFNAAGVLVEARAKAILDFLDALLELSEEQQFVAEALEKGTLPLLKDQVKSVMEQNWDELASSPPDMDYDPEARILCALYVVVSILLELAEGPTSVSS
